session,trialno,difficulty,accuracy,sideChosen,durExplorationPeriod,durDecisionPeriod,durPeriodTotal,SwitchesExplorationPeriod,SwitchesDecisionPeriod,NbSwitches,FixNbExplorationPeriod,FixNbDecisionPeriod,FixNb,FixNbInTDecision,FixNbInLExploration,FixNbInRExploration,FixNbBottomExploration,LookDurInTDecision,LookDurInLExploration,LookDurInRExploration,LookDurBottomExploration
curE002a,8,Easy,0.0,left,11270,924,12194,6,0,6,20,2,22,1,13,5,18,1208,4404,1076,5480
curE002a,9,Easy,1.0,left,2498,2182,4680,2,0,2,6,4,10,3,3,2,5,2176,1036,634,1670
curE002a,10,Easy,1.0,right,9912,2914,12826,3,1,4,11,6,17,3,3,5,8,2020,754,1904,2658
curE002a,11,Medium,1.0,right,2328,1582,3910,2,1,3,5,5,10,3,2,1,3,1780,584,410,994
curE002a,12,Medium,0.0,left,14272,984,15256,5,1,6,23,3,26,1,14,7,21,1296,4854,2700,7554
curE002a,13,Medium,1.0,left,13628,2218,15846,6,1,7,20,7,27,5,8,8,16,2850,3186,3482,6668
curE002a,14,Medium,0.0,left,5326,1600,6926,3,0,3,10,3,13,2,6,3,9,1352,2148,1016,3164
curE002a,16,Medium,0.0,left,2328,2150,4478,1,0,1,6,4,10,2,2,2,4,1726,458,542,1000
curE002a,19,Medium,0.0,left,5928,1200,7128,2,0,2,4,3,7,2,3,0,3,854,1438,0,1438
curE002a,20,Medium,0.0,right,3648,5432,9080,3,1,4,10,10,20,8,6,2,8,4368,2040,410,2450
curE002a,21,Easy,1.0,left,3532,3514,7046,2,2,4,6,4,10,1,1,2,3,1304,416,328,744
curE002a,24,Easy,1.0,right,3680,2750,6430,3,1,4,8,7,15,5,2,5,7,2244,690,1896,2586
curE002a,25,Easy,1.0,right,3816,1282,5098,2,0,2,8,3,11,2,2,4,6,1852,598,1772,2370
curE004a,8,Easy,1.0,left,4210,5898,10108,1,2,3,11,14,25,12,0,7,7,6210,0,2618,2618
curE004a,9,Easy,1.0,left,3682,1168,4850,1,0,1,8,3,11,2,7,0,7,1150,2952,0,2952
curE004a,10,Medium,0.0,left,10760,1784,12544,3,1,4,15,5,20,3,7,5,12,2074,2730,2440,5170
curE004a,13,Easy,0.0,right,5680,634,6314,3,0,3,15,2,17,1,2,10,12,322,300,4018,4318
curE004a,14,Easy,1.0,right,2332,3366,5698,1,1,2,6,10,16,7,4,0,4,2762,930,0,930
curE004a,15,Easy,1.0,left,19922,1350,21272,4,0,4,20,2,22,2,13,5,18,622,5360,1166,6526
curE004a,16,Medium,1.0,right,6612,1418,8030,3,1,4,17,4,21,3,12,2,14,1578,4002,996,4998
curE004a,21,Hard,1.0,left,4476,1868,6344,2,0,2,11,2,13,2,3,6,9,1066,666,1100,1766
curE004a,28,Medium,1.0,left,9512,1600,11112,2,0,2,9,4,13,3,2,5,7,1614,848,2614,3462
curE004a,29,Medium,0.0,left,3660,1648,5308,1,0,1,9,5,14,4,6,0,6,1870,2170,0,2170
curE004a,38,Easy,0.0,left,15544,1216,16760,6,0,6,27,3,30,2,8,18,26,1106,2512,6910,9422
curE004a,41,Easy,1.0,right,4882,3066,7948,2,0,2,6,10,16,7,4,1,5,2108,1330,448,1778
curE004a,42,Easy,1.0,left,2328,1400,3728,0,1,1,3,4,7,2,0,0,0,1844,0,0,0
curE004a,45,Medium,1.0,right,9292,1250,10542,4,1,5,20,3,23,2,12,5,17,676,3046,1952,4998
curE004a,46,Medium,0.0,left,2682,2216,4898,1,0,1,4,6,10,4,0,3,3,2174,0,1896,1896
curE004a,47,Medium,0.0,right,3942,2716,6658,2,0,2,10,4,14,3,2,7,9,2524,672,2474,3146
curE004a,52,Easy,0.0,right,8348,1832,10180,3,0,3,22,4,26,3,17,4,21,1874,6018,966,6984
curE004a,53,Easy,1.0,left,5076,2732,7808,2,1,3,12,5,17,4,3,5,8,3606,936,1996,2932
curE004a,54,Easy,0.0,left,2326,766,3092,2,1,3,6,3,9,1,1,3,4,670,558,808,1366
curE004a,55,Easy,0.0,right,8230,8280,16510,1,2,3,17,15,32,11,15,1,16,6450,4964,170,5134
curE004a,56,Easy,1.0,left,12908,1666,14574,4,0,4,22,5,27,4,13,6,19,2204,3958,2392,6350
curE004a,57,Easy,0.0,left,5248,1700,6948,3,0,3,8,4,12,2,2,5,7,1164,754,1404,2158
curE004a,58,Easy,0.0,left,8246,1732,9978,2,0,2,12,4,16,3,3,7,10,1658,794,3394,4188
curE004a,64,Easy,0.0,left,9560,2034,11594,3,1,4,20,5,25,4,6,12,18,2028,2020,3654,5674
curE004a,65,Easy,1.0,left,4564,10040,14604,1,1,2,7,12,19,11,5,0,5,5092,1152,0,1152
curE008a,9,Easy,0.0,right,9994,7048,17042,2,0,2,15,11,26,10,12,2,14,3880,5620,1680,7300
curE008a,10,Easy,0.0,left,8692,4116,12808,3,0,3,18,9,27,8,10,7,17,4114,4304,3060,7364
curE008a,11,Easy,1.0,left,5930,3000,8930,1,1,2,10,8,18,6,7,2,9,2662,2300,576,2876
curE008a,12,Easy,1.0,left,3798,5500,9298,2,1,3,8,13,21,12,4,3,7,4332,1026,1918,2944
curE008a,13,Medium,1.0,left,12296,766,13062,6,1,7,19,3,22,1,5,11,16,350,1630,3824,5454
curE008a,14,Medium,0.0,left,7480,7614,15094,3,0,3,14,17,31,15,10,3,13,6864,4458,1872,6330
curE008a,15,Medium,0.0,left,2564,4664,7228,1,0,1,7,10,17,9,5,0,5,3664,1962,0,1962
curE008a,17,Easy,0.0,right,2648,5916,8564,2,1,3,8,7,15,5,5,2,7,3776,1172,780,1952
curE008a,18,Easy,1.0,left,7962,9448,17410,2,2,4,5,17,22,12,1,3,4,5232,280,2116,2396
curE008a,20,Easy,0.0,left,7694,8682,16376,2,1,3,14,16,30,15,8,5,13,6912,3414,2020,5434
curE008a,21,Easy,0.0,left,3198,2000,5198,1,0,1,9,2,11,1,8,0,8,822,2622,0,2622
curE008a,25,Easy,1.0,right,4448,766,5214,3,1,4,8,3,11,1,4,3,7,592,1100,2396,3496
curE009a,9,Easy,1.0,left,3798,3032,6830,1,0,1,10,9,19,8,0,9,9,3032,0,2714,2714
curE009a,10,Easy,1.0,right,8758,3150,11908,3,1,4,24,7,31,5,16,7,23,2550,4588,2108,6696
curE009a,11,Medium,0.0,left,9524,3232,12756,2,0,2,18,7,25,6,1,14,15,3096,310,3904,4214
curE009a,12,Medium,0.0,left,3316,4564,7880,2,2,4,8,8,16,4,2,5,7,3434,704,1472,2176
curE009a,14,Easy,1.0,right,2726,2016,4742,1,0,1,6,4,10,3,3,2,5,1900,1188,480,1668
curE009a,15,Easy,1.0,right,2998,3500,6498,2,1,3,7,10,17,7,4,2,6,2814,1572,486,2058
curE009a,16,Medium,1.0,left,4476,1016,5492,2,1,3,13,3,16,1,7,4,11,428,1874,1226,3100
curE009a,18,Medium,1.0,right,4526,2032,6558,2,1,3,9,7,16,5,5,3,8,2058,988,716,1704
curE009a,23,Easy,1.0,left,12262,3332,15594,5,0,5,25,7,32,6,11,12,23,3326,3692,2952,6644
curE009a,29,Easy,0.0,right,18828,10076,28904,4,0,4,38,16,54,16,22,14,36,5986,8984,5780,14764
curE009a,34,Easy,1.0,right,4514,2350,6864,3,0,3,10,6,16,5,8,0,8,2486,3170,0,3170
curE009a,35,Easy,1.0,left,19844,10074,29918,3,0,3,18,20,38,20,2,11,13,6240,1620,7556,9176
curE009a,37,Medium,0.0,right,6114,2684,8798,3,0,3,16,6,22,5,4,11,15,2678,1050,3898,4948
curE009a,38,Medium,0.0,right,5442,2232,7674,3,1,4,13,6,19,4,7,5,12,2180,1642,2236,3878
curE009a,39,Easy,0.0,right,2676,10042,12718,1,0,1,7,21,28,21,0,5,5,8726,0,1658,1658
curE009a,40,Easy,1.0,right,5046,1800,6846,2,0,2,14,5,19,4,3,9,12,1914,710,2968,3678
curE009a,42,Easy,0.0,right,7964,1432,9396,4,0,4,13,3,16,2,5,7,12,1440,2510,3926,6436
curE009a,45,Easy,0.0,left,2330,1400,3730,1,0,1,3,3,6,2,0,3,3,860,0,490,490
curE009a,47,Easy,1.0,right,2330,2832,5162,2,0,2,5,6,11,5,2,1,3,1498,644,144,788
curE009a,48,Easy,0.0,right,2598,3200,5798,1,1,2,2,3,5,1,2,0,2,246,436,0,436
curE009a,49,Easy,1.0,left,14928,1914,16842,4,1,5,19,3,22,2,10,7,17,1840,3654,1738,5392
curE009a,50,Easy,0.0,right,3410,8998,12408,2,1,3,9,8,17,6,5,2,7,3010,1676,644,2320
curE009a,52,Easy,1.0,left,7676,4298,11974,4,1,5,12,12,24,10,5,5,10,4146,2464,1694,4158
curE009a,55,Easy,0.0,left,11356,1766,13122,2,1,3,20,4,24,2,11,7,18,1714,3662,3058,6720
curE011a,7,Easy,1.0,left,4230,2182,6412,2,0,2,12,3,15,2,4,7,11,1886,1456,1948,3404
curE011a,8,Easy,1.0,right,4232,2482,6714,2,0,2,11,5,16,4,4,6,10,2478,1000,2104,3104
curE011a,9,Medium,1.0,right,5976,1850,7826,1,0,1,12,3,15,2,0,11,11,1850,0,5210,5210
curE011a,10,Medium,1.0,right,3278,1748,5026,2,0,2,4,3,7,2,1,2,3,1746,430,1994,2424
curE011a,11,Hard,0.0,right,5164,4882,10046,2,0,2,13,10,23,8,7,5,12,2882,2190,1816,4006
curE011a,12,Hard,1.0,left,2932,1600,4532,2,0,2,8,3,11,2,3,4,7,1580,936,1322,2258
curE011a,13,Hard,1.0,left,2332,1816,4148,1,0,1,2,5,7,4,0,1,1,2750,0,318,318
curE011a,14,xHard,0.0,left,7962,1200,9162,3,1,4,15,3,18,1,6,8,14,1142,3356,3274,6630
curE011a,15,xHard,1.0,left,3514,1932,5446,1,1,2,7,4,11,3,3,3,6,1702,1540,1002,2542
curE011a,16,xHard,1.0,right,2860,2200,5060,2,0,2,10,6,16,5,4,5,9,1508,952,1226,2178
curE011a,17,xHard,0.0,right,12556,2916,15472,2,0,2,29,5,34,4,17,11,28,2922,6368,4360,10728
curE011a,18,xHard,1.0,left,3014,4382,7396,1,0,1,6,7,13,6,0,4,4,3208,0,1762,1762
curE011a,20,xHard,1.0,left,7448,10246,17694,2,0,2,14,15,29,14,4,8,12,7634,996,2468,3464
curE011a,21,xHard,1.0,left,2830,650,3480,2,1,3,4,2,6,0,1,2,3,536,840,1224,2064
curE011a,22,xHard,1.0,left,4448,2666,7114,3,1,4,11,6,17,3,5,5,10,1840,1960,1608,3568
curE011a,23,xHard,0.0,left,11924,1816,13740,3,0,3,24,3,27,2,9,14,23,1400,4712,5134,9846
curE011a,24,xHard,1.0,left,7312,2000,9312,3,0,3,14,4,18,3,5,7,12,2452,1258,3630,4888
curE011a,25,xHard,0.0,left,4342,1716,6058,2,0,2,11,4,15,3,2,8,10,1708,926,2496,3422
curE011a,27,xHard,1.0,left,2414,2848,5262,2,1,3,7,8,15,6,3,3,6,2116,886,860,1746
curE011a,28,xHard,1.0,left,10080,1016,11096,1,2,3,5,3,8,0,4,0,4,238,674,0,674
curE011a,34,xHard,0.0,left,14078,3948,18026,2,0,2,17,6,23,4,7,9,16,3172,2372,3988,6360
curE011a,35,xHard,1.0,left,2328,2816,5144,1,1,2,6,6,12,4,5,0,5,2192,1560,0,1560
curE012a,7,Easy,0.0,right,3216,2148,5364,1,1,2,6,5,11,3,3,2,5,1732,1222,798,2020
curE012a,8,Easy,1.0,right,2848,566,3414,2,1,3,4,2,6,0,1,2,3,412,176,1640,1816
curE012a,9,Easy,1.0,left,2482,1134,3616,2,0,2,6,3,9,2,2,3,5,1136,500,990,1490
curE012a,10,Medium,1.0,right,6418,1962,8380,3,0,3,9,4,13,3,1,6,7,2084,472,1932,2404
curE012a,12,Hard,0.0,left,3732,1134,4866,2,1,3,8,4,12,2,4,3,7,1080,1002,694,1696
curE012a,13,Hard,1.0,left,6880,1032,7912,2,1,3,13,3,16,1,6,2,8,1222,1188,752,1940
curE012a,14,Hard,1.0,left,4666,3948,8614,2,0,2,8,4,12,3,1,5,6,1532,134,1734,1868
curE012a,16,xHard,0.0,left,2948,666,3614,2,1,3,4,2,6,0,2,1,3,534,906,1214,2120
curE012a,17,xHard,0.0,left,5064,1504,6568,1,1,2,8,4,12,2,5,1,6,1558,1714,310,2024
curE012a,18,Hard,1.0,left,4664,1682,6346,2,0,2,9,3,12,2,7,1,8,1642,3264,410,3674
curE012a,22,xHard,0.0,right,2328,3666,5994,1,0,1,3,7,10,5,1,0,1,2720,204,0,204
curE012a,25,xHard,1.0,right,2332,1498,3830,1,0,1,6,4,10,3,5,0,5,1930,1166,0,1166
curE012a,26,xHard,0.0,left,2448,666,3114,1,1,2,7,2,9,0,6,0,6,412,1286,0,1286
curE012a,28,Hard,1.0,left,9496,6098,15594,2,0,2,17,8,25,8,4,12,16,1994,2674,3116,5790
curE012a,29,Hard,1.0,left,3782,2316,6098,2,0,2,6,3,9,2,3,2,5,1492,1244,726,1970
curE012a,33,xHard,1.0,right,5310,6166,11476,2,0,2,12,4,16,4,7,3,10,1748,2676,1492,4168
curE012a,34,xHard,0.0,left,2516,1500,4016,1,1,2,2,5,7,4,2,0,2,834,826,0,826
curE012a,38,Hard,0.0,left,2332,1318,3650,2,0,2,7,3,10,2,2,2,4,1462,486,460,946
curE012a,41,Hard,1.0,right,9396,2334,11730,3,1,4,17,4,21,3,11,3,14,1912,3218,932,4150
curE012a,42,xHard,0.0,left,2332,1682,4014,1,2,3,5,3,8,1,1,1,2,1734,246,370,616
curE012a,43,xHard,1.0,right,3210,9448,12658,2,1,3,7,8,15,5,3,3,6,2226,1348,980,2328
curE012a,44,xHard,1.0,left,7714,7148,14862,2,0,2,10,16,26,16,5,3,8,6032,1912,1516,3428
curE012a,45,xHard,0.0,left,4716,2348,7064,2,0,2,10,5,15,3,2,3,5,3022,444,1768,2212
curE013a,7,Easy,0.0,left,5596,1084,6680,3,0,3,14,3,17,2,5,6,11,1048,1872,2254,4126
curE013a,8,Easy,0.0,left,19626,1050,20676,5,0,5,29,3,32,2,8,20,28,1014,2996,7224,10220
curE013a,10,Easy,1.0,left,4782,1282,6064,3,0,3,14,3,17,2,4,6,10,1132,1324,1758,3082
curE013a,11,Easy,0.0,left,6376,2000,8376,4,0,4,15,6,21,5,6,8,14,1974,1668,3238,4906
curE013a,12,Easy,1.0,right,9348,1882,11230,4,2,6,22,3,25,1,8,11,19,1124,2324,5054,7378
curE013a,13,Easy,0.0,right,3112,1148,4260,1,1,2,7,4,11,2,4,2,6,1088,1014,768,1782
curE013a,14,Easy,0.0,left,7976,1250,9226,2,0,2,12,4,16,3,5,6,11,1238,1412,2444,3856
curE013a,16,Easy,1.0,left,6094,2666,8760,4,1,5,15,6,21,3,8,6,14,1360,2646,1150,3796
curE013a,17,Easy,0.0,left,4298,1066,5364,4,0,4,11,3,14,2,5,5,10,1046,2336,840,3176
curE013a,20,Easy,1.0,left,5980,7008,12988,3,1,4,13,9,22,7,6,4,10,3942,2720,1504,4224
curE013a,21,Medium,0.0,left,14944,1182,16126,2,0,2,27,3,30,2,21,4,25,1040,7130,1184,8314
curE013a,22,Medium,1.0,left,8328,1150,9478,4,0,4,12,3,15,2,6,5,11,1164,2064,1744,3808
curE013a,23,Medium,0.0,left,7750,1164,8914,3,0,3,10,3,13,2,5,3,8,1110,2086,696,2782
curE013a,26,Medium,1.0,right,6184,2480,8664,4,1,5,13,4,17,3,6,4,10,2212,1744,1252,2996
curE013a,27,Medium,0.0,left,3964,2166,6130,3,0,3,9,5,14,4,4,4,8,2158,830,762,1592
curE013a,28,Medium,0.0,left,10562,1134,11696,2,0,2,14,3,17,2,7,4,11,1428,1394,782,2176
curE013a,29,Easy,1.0,left,5910,1234,7144,4,1,5,11,3,14,1,6,4,10,1034,2864,1196,4060
curE013a,30,Easy,0.0,left,3248,2148,5396,2,0,2,7,5,12,4,4,2,6,1004,852,570,1422
curE013a,39,Easy,0.0,left,12412,1200,13612,2,0,2,11,3,14,2,4,5,9,1036,2270,1964,4234
curE013a,41,Easy,0.0,right,2332,1384,3716,2,0,2,6,4,10,3,1,3,4,1686,364,872,1236
curE014a,7,Easy,0.0,right,12496,10496,22992,5,1,6,18,9,27,7,8,9,17,4990,3706,2948,6654
curE014a,9,Easy,0.0,left,10478,3034,13512,3,0,3,15,6,21,5,8,5,13,3058,5008,1608,6616
curE014a,10,Easy,0.0,left,20110,7830,27940,8,2,10,20,12,32,8,4,14,18,4152,1322,6350,7672
curE014a,11,Easy,0.0,left,2694,1666,4360,2,0,2,6,3,9,2,2,3,5,1570,722,1058,1780
curE014a,12,Easy,1.0,left,13046,8768,21814,2,0,2,15,9,24,8,10,3,13,3222,4810,664,5474
curE014a,16,Easy,1.0,right,17874,3682,21556,6,0,6,35,7,42,6,8,24,32,2880,2934,9490,12424
curE014a,27,Medium,0.0,right,9224,1600,10824,2,0,2,13,2,15,2,9,3,12,844,3320,1500,4820
curE014a,28,Easy,1.0,right,2328,2514,4842,2,0,2,5,5,10,5,1,1,2,2160,800,170,970
curE014a,30,Easy,1.0,right,7412,1250,8662,4,0,4,16,3,19,2,6,9,15,1292,1538,3998,5536
curE014a,32,Medium,1.0,right,5230,2550,7780,2,0,2,8,3,11,2,2,4,6,1940,566,3444,4010
curE014a,34,Hard,0.0,left,10374,2532,12906,4,1,5,16,5,21,4,5,10,15,2186,2048,3324,5372
curE017a,7,Easy,1.0,left,2650,2582,5232,1,0,1,6,6,12,5,5,0,5,1918,1850,0,1850
curE017a,8,Easy,1.0,left,2962,1716,4678,1,0,1,6,4,10,3,3,0,3,2918,820,0,820
curE017a,9,Medium,0.0,left,4182,9530,13712,1,2,3,9,13,22,11,7,0,7,8186,2572,0,2572
curE017a,12,Easy,1.0,left,10296,3082,13378,1,1,2,13,8,21,6,11,0,11,2938,3334,0,3334
curE017a,13,Easy,0.0,left,2332,2616,4948,1,1,2,6,7,13,5,4,0,4,2406,1074,0,1074
curE017a,14,Easy,1.0,left,3166,1182,4348,2,1,3,6,3,9,2,2,2,4,1632,850,808,1658
curE017a,20,Easy,0.0,right,2632,1266,3898,2,0,2,7,3,10,2,3,3,6,1220,870,962,1832
curE017a,21,Easy,0.0,right,5316,6346,11662,2,0,2,14,14,28,13,4,7,11,5776,1342,2148,3490
curE017a,24,Easy,0.0,left,3782,6332,10114,3,0,3,9,13,22,11,1,6,7,6108,110,2504,2614
curE017a,25,Easy,1.0,right,4564,1184,5748,2,0,2,10,3,13,2,2,6,8,1646,608,2570,3178
curE017a,26,Easy,0.0,right,8362,2650,11012,1,0,1,14,4,18,3,13,0,13,2626,7566,0,7566
curE017a,27,Easy,1.0,left,8168,2596,10764,2,0,2,11,6,17,4,5,2,7,2418,4548,1424,5972
curE017a,28,Easy,1.0,right,4314,2916,7230,2,0,2,7,6,13,4,3,3,6,2406,2102,966,3068
curE017a,29,Medium,1.0,right,4144,10038,14182,1,0,1,8,4,12,4,7,0,7,1318,3366,0,3366
curE017a,31,Medium,1.0,left,4732,1382,6114,1,0,1,9,3,12,2,2,5,7,1318,1204,2616,3820
curE017a,32,Medium,1.0,right,3082,4332,7414,2,0,2,9,3,12,3,4,3,7,1966,1346,674,2020
curE017a,33,Hard,0.0,left,11864,1882,13746,2,0,2,8,5,13,3,5,2,7,1490,2574,782,3356
curE017a,34,Hard,0.0,left,2334,1566,3900,1,0,1,7,3,10,2,4,0,4,1870,1026,0,1026
curE017a,35,Medium,1.0,left,3776,2534,6310,1,0,1,10,3,13,1,5,3,8,1382,1668,632,2300
curE017a,38,Medium,0.0,left,2328,1034,3362,2,0,2,5,2,7,1,1,3,4,1214,158,1174,1332
curE017a,40,Easy,0.0,right,6480,2116,8596,3,1,4,11,5,16,3,4,6,10,2082,1634,1766,3400
curE017a,41,Easy,1.0,left,4266,1566,5832,1,1,2,9,4,13,3,0,5,5,1490,0,2174,2174
curE017a,42,Easy,1.0,right,15928,2666,18594,4,0,4,19,4,23,3,3,15,18,1964,1092,6952,8044
curE017a,43,Medium,1.0,left,8860,1732,10592,2,1,3,21,3,24,2,15,3,18,1156,5164,1108,6272
curE017a,46,Medium,0.0,right,6564,3266,9830,1,0,1,7,7,14,6,6,0,6,3094,2068,0,2068
curE017a,47,Medium,1.0,right,3182,2034,5216,1,0,1,4,5,9,4,0,3,3,2026,0,1122,1122
curE017a,48,Medium,1.0,right,3782,6264,10046,1,0,1,4,3,7,2,2,0,2,872,298,0,298
curE017a,49,Hard,1.0,left,6652,7806,14458,1,0,1,9,13,22,12,7,0,7,5536,3074,0,3074
curE018a,8,Easy,0.0,right,8112,1016,9128,1,1,2,12,3,15,1,0,11,11,976,0,5148,5148
curE018a,9,Easy,0.0,right,3214,1184,4398,2,1,3,9,3,12,1,2,6,8,1136,644,1704,2348
curE018a,10,Easy,1.0,left,3648,3482,7130,2,2,4,7,6,13,3,3,3,6,2948,2116,846,2962
curE018a,11,Easy,0.0,left,3980,2184,6164,2,0,2,11,6,17,5,3,6,9,2132,1080,1956,3036
curE018a,12,Easy,1.0,right,4632,1582,6214,3,0,3,12,4,16,3,4,7,11,1564,2206,1562,3768
curE018a,13,Easy,1.0,right,4894,1284,6178,3,0,3,11,3,14,2,5,4,9,1976,1580,1660,3240
curE018a,14,Medium,0.0,right,8998,1566,10564,2,0,2,12,4,16,3,2,8,10,1212,998,4242,5240
curE018a,16,Medium,0.0,right,2330,2666,4996,1,0,1,5,6,11,5,0,4,4,2660,0,1752,1752
curE018a,19,Medium,0.0,left,2334,1698,4032,1,0,1,7,4,11,3,0,6,6,2026,0,1442,1442
curE018a,20,Medium,1.0,left,4198,1716,5914,2,0,2,10,5,15,4,3,6,9,1718,1392,2028,3420
curE018a,21,Medium,1.0,left,2332,2232,4564,2,1,3,5,6,11,4,2,1,3,2462,1012,154,1166
curE018a,23,Hard,0.0,right,2930,1184,4114,2,0,2,8,3,11,2,2,5,7,1102,596,1498,2094
curE018a,24,Hard,1.0,right,2332,5532,7864,1,3,4,6,8,14,4,4,0,4,2578,1318,0,1318
curE018a,25,Hard,0.0,left,8046,1268,9314,3,0,3,17,3,20,2,6,9,15,730,1786,4280,6066
curE018a,26,Hard,0.0,left,3632,2798,6430,2,0,2,8,8,16,7,4,3,7,2790,1672,1314,2986
curE018a,27,Medium,1.0,left,2346,3134,5480,2,0,2,7,7,14,6,3,3,6,2754,720,974,1694
curE018a,29,Medium,1.0,left,2982,2082,5064,2,1,3,6,3,9,1,3,2,5,650,1622,698,2320
curE018a,31,Medium,0.0,left,4882,2016,6898,1,0,1,6,4,10,2,1,4,5,1732,590,1848,2438
curE018a,32,Medium,1.0,right,12078,1366,13444,4,0,4,29,3,32,2,11,15,26,1340,3362,5658,9020
curE018a,33,Medium,1.0,left,3632,1382,5014,2,0,2,7,4,11,3,2,4,6,1370,472,2400,2872
curE018a,34,Hard,1.0,left,4494,3384,7878,3,0,3,11,8,19,7,4,5,9,3196,1102,2312,3414
curE018a,35,Hard,1.0,right,8464,4416,12880,3,1,4,17,10,27,8,11,5,16,3986,4828,2584,7412
curE018a,36,xHard,1.0,left,3882,8212,12094,2,0,2,9,6,15,5,7,1,8,2782,2280,180,2460
curE018a,38,xHard,0.0,left,6082,1598,7680,2,1,3,8,5,13,3,2,5,7,1552,522,2766,3288
curE018a,39,Hard,0.0,left,8064,2030,10094,0,0,0,3,5,8,4,0,0,0,1486,0,0,0
curE018a,40,Hard,0.0,right,2830,566,3396,2,1,3,8,1,9,0,4,2,6,478,1282,584,1866
curE018a,42,Medium,1.0,left,3064,1660,4724,2,1,3,10,6,16,4,5,3,8,1376,1364,994,2358
curE018a,43,Hard,1.0,right,3762,2584,6346,2,0,2,12,6,18,5,7,4,11,2582,1974,1116,3090
curE018a,44,Hard,1.0,right,4380,582,4962,4,1,5,9,2,11,0,3,4,7,822,1224,1806,3030
curE018a,47,xHard,1.0,right,2666,1666,4332,1,0,1,7,2,9,2,2,3,5,1136,716,1194,1910
curE018a,48,xHard,1.0,left,2332,1916,4248,1,0,1,5,3,8,2,0,1,1,1190,0,248,248
curE018a,50,xHard,1.0,left,6114,2200,8314,2,0,2,11,3,14,2,6,3,9,1714,1748,1052,2800
curE018a,51,xHard,0.0,left,3566,2100,5666,2,0,2,6,4,10,3,3,1,4,1260,730,180,910
curE018a,53,xHard,0.0,right,4130,584,4714,3,1,4,12,1,13,0,7,3,10,242,2022,930,2952
curE018a,57,xHard,0.0,right,2330,8180,10510,2,1,3,6,15,21,12,3,2,5,5994,638,994,1632
curE019a,7,Easy,0.0,left,2798,584,3382,2,1,3,6,2,8,0,3,2,5,530,1122,824,1946
curE019a,8,Easy,0.0,right,6066,1648,7714,2,0,2,14,4,18,3,6,7,13,1174,2274,2468,4742
curE019a,9,Easy,0.0,right,4978,4266,9244,3,0,3,10,3,13,2,4,4,8,1126,2388,1050,3438
curE019a,10,Easy,1.0,right,3866,2332,6198,1,0,1,10,5,15,4,4,5,9,2334,1408,1686,3094
curE019a,11,Easy,1.0,right,4298,1982,6280,2,0,2,9,4,13,3,2,5,7,2406,864,1934,2798
curE019a,13,Medium,1.0,left,8162,3816,11978,6,0,6,16,8,24,7,7,7,14,3732,2590,2500,5090
curE019a,14,Medium,0.0,left,16894,4732,21626,6,0,6,27,8,35,7,6,21,27,4202,2684,7250,9934
curE019a,15,Medium,1.0,right,5164,4716,9880,3,1,4,14,3,17,2,4,9,13,1390,1148,3128,4276
curE019a,17,Medium,1.0,right,11376,2332,13708,3,0,3,15,6,21,5,7,4,11,2798,3034,1690,4724
curE019a,18,Medium,0.0,left,7430,2116,9546,3,1,4,20,5,25,3,13,5,18,1684,3616,1642,5258
curE019a,19,Medium,1.0,left,11212,5998,17210,2,0,2,12,8,20,8,2,8,10,4560,332,3208,3540
curE019a,20,Medium,1.0,left,7178,5164,12342,3,2,5,14,11,25,7,5,8,13,3614,1652,2024,3676
curE019a,22,Hard,0.0,left,15512,3582,19094,8,1,9,31,9,40,6,13,16,29,3094,5830,6250,12080
curE019a,26,Hard,0.0,left,8862,5416,14278,4,1,5,12,9,21,7,5,5,10,5024,3730,3034,6764
curE019a,27,Hard,0.0,right,5476,3050,8526,3,0,3,13,4,17,4,8,4,12,2172,2860,1604,4464
curE019a,29,Medium,1.0,right,5582,3498,9080,1,0,1,4,7,11,6,0,4,4,2968,0,2042,2042
curE019a,30,Medium,0.0,left,5562,4382,9944,3,0,3,10,7,17,6,1,6,7,4552,370,3654,4024
curE019a,31,Medium,1.0,left,9596,8996,18592,3,0,3,13,7,20,6,8,4,12,3778,4772,2000,6772
curE019a,34,Medium,1.0,right,14278,6748,21026,6,1,7,27,8,35,6,10,16,26,3750,4864,7506,12370
curE019a,35,Hard,0.0,right,8930,8010,16940,7,1,8,18,12,30,10,5,11,16,5278,2038,3598,5636
curE019a,36,Hard,1.0,left,4712,2982,7694,2,1,3,9,5,14,4,3,3,6,2868,966,720,1686
curE019a,37,Hard,1.0,left,4148,2650,6798,2,1,3,11,5,16,4,5,5,10,2548,1414,1654,3068
curE024a,8,Easy,0.0,left,8180,4052,12232,1,1,2,16,11,27,9,9,4,13,3240,5122,1486,6608
curE024a,11,Easy,0.0,left,15378,2116,17494,6,0,6,27,6,33,5,15,11,26,2060,5968,2942,8910
curE024a,14,Easy,1.0,left,6780,1916,8696,3,1,4,18,6,24,4,9,8,17,1860,3182,2026,5208
curE024a,15,Medium,1.0,left,6546,2016,8562,3,0,3,18,6,24,5,7,9,16,1888,2658,2564,5222
curE024a,16,Medium,0.0,right,5032,916,5948,2,1,3,10,3,13,1,6,3,9,854,3052,898,3950
curE024a,17,Medium,0.0,left,12062,1600,13662,3,0,3,17,5,22,4,10,5,15,1376,5394,1652,7046
curE024a,21,Easy,1.0,left,4730,1500,6230,2,0,2,9,4,13,3,5,2,7,1468,2886,604,3490
curE024a,27,Easy,0.0,left,3716,1400,5116,3,0,3,8,3,11,2,4,2,6,1306,1634,780,2414
curE024a,28,Easy,1.0,left,5580,1650,7230,4,0,4,14,4,18,3,5,8,13,1648,1642,2416,4058
curE024a,35,Easy,0.0,left,13390,2366,15756,4,0,4,23,3,26,2,17,5,22,1408,6114,1808,7922
curE024a,36,Easy,0.0,left,4310,9780,14090,2,1,3,10,14,24,13,2,7,9,5906,690,2912,3602
curE024a,37,Easy,1.0,left,2332,1432,3764,1,0,1,6,4,10,3,0,3,3,894,0,704,704
curE024a,38,Easy,0.0,right,8294,1066,9360,5,0,5,16,3,19,1,6,9,15,812,2718,3630,6348
curE024a,40,Easy,0.0,right,4496,2166,6662,3,0,3,12,4,16,3,5,6,11,2050,1810,1818,3628
curE024a,41,Easy,1.0,right,2930,1466,4396,3,0,3,9,4,13,3,3,4,7,1176,968,1084,2052
curE024a,42,Easy,0.0,left,4514,1434,5948,2,0,2,7,2,9,1,3,4,7,456,990,882,1872
curE027a,7,Easy,1.0,left,2400,1416,3816,0,1,1,3,3,6,1,0,0,0,2284,0,0,0
curE027a,8,Easy,1.0,left,2332,1416,3748,0,1,1,0,3,3,1,0,0,0,830,0,0,0
curE027a,9,Medium,0.0,left,2330,3248,5578,0,0,0,2,2,4,1,0,0,0,1302,0,0,0
curE027a,11,Medium,1.0,left,2332,1232,3564,0,0,0,0,3,3,2,0,0,0,694,0,0,0
curE027a,12,Medium,1.0,right,2332,1932,4264,0,0,0,0,4,4,3,0,0,0,1390,0,0,0
curE027a,16,Medium,1.0,right,5396,1384,6780,2,1,3,6,3,9,1,3,2,5,1282,1362,1310,2672
curE027a,18,Medium,0.0,left,2882,1134,4016,0,1,1,5,3,8,1,0,2,2,2200,0,936,936
curE027a,19,Medium,1.0,left,2762,1066,3828,0,1,1,4,3,7,1,0,2,2,1718,0,942,942
curE027a,20,Medium,1.0,left,2330,1398,3728,0,0,0,0,4,4,2,0,0,0,522,0,0,0
curE027a,21,Hard,0.0,left,2332,1166,3498,0,0,0,0,3,3,2,0,0,0,622,0,0,0
curE027a,24,Medium,1.0,left,2328,1400,3728,0,0,0,0,3,3,2,0,0,0,856,0,0,0
curE027a,25,Medium,0.0,left,2332,1848,4180,0,1,1,0,3,3,1,0,0,0,1270,0,0,0
curE027a,26,Medium,1.0,left,6312,1482,7794,0,0,0,3,4,7,3,0,0,0,2788,0,0,0
curE027a,29,Medium,1.0,left,2332,1250,3582,1,1,2,2,2,4,1,0,1,1,1310,0,346,346
curE027a,30,Medium,1.0,left,3566,1082,4648,0,0,0,0,3,3,2,0,0,0,542,0,0,0
curE030a,7,Easy,0.0,right,4298,1548,5846,1,0,1,7,5,12,4,2,4,6,1496,1044,714,1758
curE030a,12,Easy,1.0,right,3948,1548,5496,1,0,1,8,3,11,2,3,4,7,1240,984,1968,2952
curE030a,15,Easy,0.0,right,2760,1384,4144,2,0,2,8,4,12,3,2,5,7,1392,468,1236,1704
curE030a,19,Easy,0.0,right,8964,1966,10930,4,1,5,20,4,24,2,16,3,19,1738,6236,928,7164
curE030a,20,Easy,1.0,left,3114,1900,5014,2,1,3,9,6,15,4,4,3,7,1372,1156,992,2148
curE030a,21,Easy,1.0,right,2328,1532,3860,2,0,2,6,4,10,3,3,1,4,1756,952,224,1176
curE030a,23,Medium,1.0,left,2328,3182,5510,2,0,2,7,8,15,7,4,2,6,2954,1148,408,1556
curE030a,26,Hard,1.0,right,7260,1732,8992,5,0,5,21,3,24,2,8,11,19,1522,2786,2644,5430
curE030a,27,Hard,1.0,right,2328,4066,6394,1,0,1,4,2,6,2,1,2,3,988,448,476,924
curE030a,28,xHard,1.0,left,4132,1782,5914,3,0,3,7,0,7,0,4,3,7,0,1860,1144,3004
curE030a,31,xHard,0.0,right,3798,1616,5414,2,0,2,10,4,14,3,3,5,8,1402,870,1518,2388
curE030a,36,xHard,0.0,left,2330,1816,4146,2,0,2,5,4,9,3,2,2,4,1984,786,418,1204
curE030a,37,xHard,1.0,left,2332,1650,3982,2,0,2,5,2,7,1,3,1,4,814,882,264,1146
curE034a,8,Easy,1.0,left,5794,7082,12876,2,0,2,13,6,19,6,6,5,11,3250,2818,1042,3860
curE034a,13,Easy,0.0,right,9246,9230,18476,2,0,2,20,0,20,0,12,7,19,454,3522,2712,6234
curE034a,14,Easy,0.0,left,5178,600,5778,3,1,4,12,2,14,0,3,6,9,0,1036,2638,3674
curE034a,16,Easy,1.0,right,18894,1948,20842,4,1,5,24,6,30,4,17,6,23,1904,6824,1948,8772
curE034a,17,Easy,0.0,right,16206,5016,21222,3,1,4,15,9,24,7,12,3,15,2194,3774,1056,4830
curE034a,18,Easy,0.0,right,4944,7698,12642,2,0,2,5,8,13,7,3,1,4,1996,962,364,1326
curE034a,21,Easy,0.0,right,17866,3510,21376,1,1,2,22,7,29,6,10,10,20,3196,3428,2820,6248
curE034a,24,Easy,1.0,left,5146,10040,15186,1,0,1,10,5,15,5,3,6,9,1616,1094,2640,3734
curE034a,25,Easy,1.0,right,8292,5366,13658,3,0,3,6,10,16,8,2,3,5,3018,1146,2660,3806
curE034a,26,Medium,1.0,right,9376,7748,17124,3,1,4,16,17,33,15,12,3,15,6574,3700,1246,4946
curE034a,31,Medium,1.0,right,8948,2348,11296,1,1,2,9,6,15,5,5,3,8,2294,1786,3870,5656
curE034a,37,Medium,1.0,left,14608,10038,24646,4,0,4,32,0,32,0,16,15,31,108,5296,4904,10200
curE034a,41,Medium,0.0,right,4244,10038,14282,2,0,2,7,0,7,0,1,6,7,0,562,2518,3080
curE034a,49,Medium,1.0,right,10812,10504,21316,1,0,1,13,10,23,10,9,1,10,3088,3126,146,3272
curE038a,7,Easy,0.0,left,2332,1098,3430,0,0,0,4,3,7,2,0,0,0,2062,0,0,0
curE038a,15,Easy,1.0,left,2328,2270,4598,1,1,2,6,5,11,4,3,0,3,2150,986,0,986
curE038a,16,Easy,1.0,left,2330,1600,3930,2,1,3,6,4,10,3,2,1,3,2324,518,274,792
curE038a,17,Medium,1.0,left,2334,1932,4266,1,0,1,5,5,10,3,0,3,3,2126,0,1046,1046
curE038a,18,Medium,1.0,right,2332,918,3250,0,1,1,2,3,5,1,0,0,0,2014,0,0,0
curE038a,19,Hard,1.0,left,2328,2098,4426,1,1,2,5,4,9,2,2,0,2,1370,930,0,930
curE038a,20,Hard,1.0,right,2332,3182,5514,0,1,1,5,6,11,4,0,0,0,2208,0,0,0
curE038a,21,xHard,0.0,right,2414,2816,5230,1,1,2,6,6,12,4,1,0,1,3704,306,0,306
curE038a,22,xHard,1.0,right,2332,1116,3448,0,1,1,3,3,6,2,0,0,0,1842,0,20,20
curE038a,27,xHard,0.0,right,2328,982,3310,0,1,1,4,3,7,1,0,0,0,2600,0,0,0
curE038a,28,Hard,1.0,right,2328,2050,4378,0,1,1,3,6,9,4,0,0,0,2792,0,0,0
curE038a,29,Hard,0.0,left,4842,1668,6510,0,0,0,7,3,10,2,1,0,1,2826,582,0,582
curE038a,30,Hard,1.0,right,2432,1082,3514,2,0,2,5,3,8,2,3,0,3,1524,1020,0,1020
curE038a,31,Hard,1.0,left,2976,1400,4376,0,0,0,6,1,7,1,0,1,1,1598,0,382,382
curE038a,32,xHard,0.0,right,2326,2272,4598,1,1,2,3,3,6,1,0,1,1,1376,0,188,188
curE038a,33,xHard,1.0,left,2332,2034,4366,0,1,1,2,5,7,3,0,0,0,2278,0,0,0
curE038a,34,xHard,1.0,right,2332,1384,3716,1,0,1,5,2,7,2,2,0,2,1714,614,0,614
curE038a,35,xHard,1.0,right,2332,3564,5896,1,1,2,5,8,13,4,0,2,2,2618,0,448,448
curE038a,36,xHard,0.0,right,2330,1084,3414,1,0,1,4,2,6,0,0,1,1,1618,0,136,136
curE038a,37,xHard,1.0,right,5496,7564,13060,3,0,3,8,7,15,5,2,4,6,4112,1030,2926,3956
curE038a,38,xHard,0.0,left,3260,966,4226,1,1,2,8,3,11,1,0,3,3,2744,0,762,762
curE038a,39,xHard,0.0,right,4064,1182,5246,0,0,0,4,3,7,2,0,0,0,1144,0,0,0
curE038a,40,Hard,0.0,right,2614,984,3598,1,1,2,6,3,9,1,3,0,3,1632,626,0,626
curE038a,41,Hard,1.0,left,3682,3858,7540,1,1,2,4,3,7,1,0,1,1,1340,0,200,200
curE038a,42,Hard,1.0,right,2332,1000,3332,0,1,1,0,2,2,0,0,0,0,0,0,0,0
curE038a,43,xHard,0.0,right,2394,1666,4060,1,0,1,5,4,9,3,3,0,3,2292,786,0,786
curE038a,44,xHard,1.0,right,3294,3232,6526,2,1,3,9,8,17,5,4,3,7,2804,868,970,1838
curE038a,47,xHard,0.0,right,19442,918,20360,4,1,5,16,3,19,1,8,4,12,840,2226,1732,3958
curE038a,49,Hard,0.0,right,12708,1150,13858,5,0,5,17,1,18,0,6,10,16,0,2056,3294,5350
curE038a,50,Medium,0.0,right,3982,934,4916,3,0,3,7,1,8,1,3,2,5,888,1840,772,2612
curE038a,51,Medium,1.0,left,2330,7014,9344,1,0,1,3,9,12,7,1,0,1,4490,202,0,202
curE038a,52,Medium,0.0,left,2332,566,2898,1,0,1,3,0,3,0,0,2,2,620,0,594,594
curE038a,55,Medium,1.0,left,3532,950,4482,2,1,3,9,3,12,1,5,1,6,1644,1470,238,1708
curE038a,56,Medium,1.0,left,2382,916,3298,2,1,3,5,2,7,1,1,1,2,1266,280,444,724
curE038a,57,Hard,0.0,left,2326,7764,10090,1,1,2,4,20,24,17,2,0,2,6392,518,0,518
curE038a,58,Hard,1.0,right,2370,1312,3682,1,0,1,4,3,7,2,2,0,2,1818,914,0,914
curE038a,59,Hard,1.0,left,11412,1384,12796,1,0,1,21,3,24,1,0,18,18,1298,0,8688,8688
curE038a,60,xHard,1.0,left,2332,866,3198,1,0,1,4,2,6,1,1,0,1,2106,196,0,196
curE038a,64,xHard,0.0,left,2614,968,3582,1,1,2,4,2,6,1,0,2,2,912,0,728,728
curE039a,7,Easy,0.0,right,7748,1432,9180,4,1,5,18,5,23,3,6,8,14,1714,2070,3624,5694
curE039a,9,Easy,1.0,right,9670,1858,11528,3,0,3,18,6,24,5,4,10,14,1908,1036,5588,6624
curE039a,10,Easy,0.0,right,8942,1200,10142,2,0,2,9,2,11,1,1,6,7,672,428,5148,5576
curE039a,11,Easy,1.0,left,16032,2596,18628,8,1,9,39,5,44,4,20,17,37,2492,7622,5424,13046
curE039a,12,Easy,1.0,right,8610,3232,11842,2,2,4,7,8,15,6,1,4,5,2592,716,1168,1884
curE039a,13,Medium,1.0,right,3548,2466,6014,3,1,4,10,5,15,3,5,4,9,2298,1312,1332,2644
curE039a,16,Medium,1.0,left,3550,7842,11392,3,2,5,7,11,18,9,3,1,4,6348,880,214,1094
curE039a,17,Medium,0.0,left,14346,9014,23360,3,1,4,17,7,24,5,9,8,17,2126,3570,2406,5976
curE039a,19,Medium,1.0,right,13100,562,13662,2,0,2,21,0,21,0,3,15,18,400,642,5848,6490
curE039a,20,Hard,0.0,right,3732,2050,5782,3,0,3,10,6,16,5,4,4,8,2116,1226,1284,2510
curE039a,23,Medium,1.0,right,5648,4482,10130,3,1,4,12,3,15,2,5,7,12,610,1458,2078,3536
curE039a,30,Medium,1.0,right,19258,4048,23306,5,1,6,29,5,34,3,15,13,28,1796,5416,5790,11206
curE039a,37,Easy,0.0,left,7836,2038,9874,3,0,3,20,5,25,4,9,9,18,1926,2306,3536,5842
curE039a,38,Easy,0.0,right,19410,6780,26190,3,1,4,44,7,51,5,24,17,41,3432,9388,5842,15230
curE039a,41,Easy,1.0,right,14190,5200,19390,5,1,6,28,9,37,7,10,17,27,4800,2868,9262,12130
curE041a,8,Easy,1.0,right,2532,10036,12568,1,0,1,7,11,18,11,5,0,5,3224,1902,0,1902
curE041a,9,Easy,1.0,right,6126,6366,12492,2,1,3,11,10,21,8,2,8,10,5850,566,4876,5442
curE041a,10,Medium,1.0,right,2416,7180,9596,1,0,1,5,13,18,11,4,0,4,3850,1476,0,1476
curE041a,15,Medium,0.0,right,2814,10040,12854,2,0,2,6,12,18,12,3,2,5,7572,1174,526,1700
curE041a,16,Medium,0.0,right,6548,2350,8898,2,0,2,10,4,14,3,3,6,9,2350,836,4880,5716
curE041a,17,Easy,1.0,right,2332,6280,8612,1,0,1,5,9,14,9,4,0,4,5100,1388,0,1388
curE041a,22,Easy,1.0,right,2332,1632,3964,0,0,0,4,4,8,3,0,0,0,2728,0,0,0
curE041a,23,Medium,0.0,right,2330,1432,3762,0,1,1,6,3,9,1,0,0,0,1822,0,0,0
curE041a,24,Medium,0.0,right,2332,1766,4098,0,0,0,5,4,9,3,0,0,0,2070,0,0,0
curE041a,27,Easy,0.0,right,2332,8180,10512,0,0,0,6,20,26,20,0,0,0,6566,0,0,0
curE041a,28,Easy,1.0,right,6730,1550,8280,3,1,4,12,3,15,2,7,3,10,1004,2366,1066,3432
curE041a,30,Easy,1.0,right,2348,10038,12386,1,0,1,5,8,13,8,0,4,4,2854,0,674,674
curE041a,33,Easy,1.0,right,8630,2966,11596,1,1,2,18,5,23,3,15,2,17,1248,4740,958,5698
curE041a,37,Easy,0.0,right,13512,1700,15212,2,1,3,16,4,20,2,4,10,14,1504,1262,4542,5804
curE045a,12,Medium,0.0,right,2594,2200,4794,2,0,2,5,3,8,2,1,3,4,2144,838,1074,1912
curE045a,13,Medium,1.0,right,2444,1732,4176,2,1,3,4,4,8,3,1,2,3,1616,1150,528,1678
curE045a,15,Medium,1.0,right,2332,2850,5182,2,1,3,3,7,10,5,1,1,2,2622,494,694,1188
curE045a,17,Hard,0.0,left,2832,1566,4398,2,0,2,6,3,9,2,1,4,5,1412,568,1306,1874
curE045a,18,Hard,1.0,left,2816,2182,4998,2,0,2,7,5,12,4,4,2,6,2118,1088,940,2028
curE045a,19,Hard,0.0,right,3680,1784,5464,3,1,4,9,6,15,4,2,6,8,1734,784,1950,2734
curE045a,20,Hard,1.0,right,12630,2030,14660,5,0,5,17,4,21,3,7,9,16,1842,2570,3466,6036
curE045a,22,Hard,1.0,left,3816,3982,7798,2,1,3,10,8,18,6,2,7,9,3350,670,2218,2888
curE045a,24,Hard,0.0,left,7380,10038,17418,6,0,6,16,8,24,8,6,8,14,2214,2490,3168,5658
curE045a,25,Hard,1.0,left,7730,2816,10546,3,0,3,15,5,20,4,3,10,13,2788,1386,3726,5112
curE045a,28,Hard,1.0,right,16028,2700,18728,5,0,5,29,5,34,4,11,17,28,2418,3274,9746,13020
curE045a,30,xHard,1.0,left,7026,3516,10542,4,1,5,16,7,23,5,9,6,15,2816,2626,3048,5674
curE045a,31,xHard,0.0,left,8182,1866,10048,7,0,7,20,4,24,3,8,11,19,1730,3304,3468,6772
curE045a,32,xHard,0.0,right,4346,1766,6112,3,0,3,10,4,14,3,4,4,8,1232,1652,1532,3184
curE045a,35,Hard,1.0,left,13628,1916,15544,3,0,3,19,5,24,5,13,4,17,1776,4392,1402,5794
curE045a,37,Hard,1.0,left,10962,1666,12628,2,1,3,17,5,22,3,7,9,16,1642,2248,3570,5818
curE046a,7,Easy,1.0,right,3998,1850,5848,1,1,2,7,5,12,3,0,5,5,3004,0,1986,1986
curE046a,8,Easy,0.0,left,10508,2650,13158,1,0,1,15,5,20,4,0,13,13,3516,0,8716,8716
curE046a,9,Easy,1.0,right,3230,1484,4714,1,0,1,5,4,9,3,2,1,3,2492,1140,258,1398
curE046a,10,Easy,0.0,right,4344,1150,5494,2,0,2,7,3,10,2,1,4,5,2126,370,1992,2362
curE046a,11,Easy,0.0,right,3360,1800,5160,2,0,2,11,5,16,4,2,7,9,1742,576,1944,2520
curE046a,14,Easy,0.0,left,2332,1000,3332,1,1,2,3,3,6,1,0,2,2,408,0,1104,1104
curE046a,15,Easy,1.0,right,2364,4266,6630,2,1,3,6,12,18,10,1,4,5,4180,284,1416,1700
curE046a,16,Easy,1.0,right,2328,1100,3428,1,0,1,2,3,5,2,0,1,1,1938,0,738,738
curE046a,17,Medium,0.0,right,8580,1366,9946,3,0,3,16,3,19,2,9,5,14,1896,3962,2718,6680
curE046a,18,Medium,1.0,right,8442,1000,9442,4,1,5,20,3,23,1,8,10,18,1390,2704,3856,6560
curE046a,21,Medium,0.0,left,2894,1018,3912,1,1,2,5,3,8,1,2,1,3,1916,878,262,1140
curE046a,22,Easy,0.0,right,2332,1282,3614,1,0,1,5,3,8,1,2,0,2,1502,900,0,900
curE046a,23,Easy,1.0,right,2332,2800,5132,1,1,2,4,6,10,4,0,3,3,3024,0,1240,1240
curE046a,24,Easy,1.0,right,2326,2916,5242,1,1,2,6,6,12,4,0,5,5,2478,0,1204,1204
curE046a,25,Medium,1.0,right,2326,2416,4742,1,0,1,5,7,12,6,0,3,3,2464,0,848,848
curE046a,26,Medium,1.0,left,13724,1900,15624,5,0,5,30,3,33,2,14,13,27,2340,5368,6332,11700
curE046a,27,Hard,0.0,left,2510,966,3476,1,0,1,6,2,8,1,0,4,4,716,232,1160,1392
curE046a,29,Medium,1.0,left,2678,2000,4678,2,1,3,5,6,11,4,2,2,4,1926,1028,996,2024
curE046a,30,Medium,1.0,left,11876,2066,13942,5,1,6,26,6,32,4,10,14,24,1990,3690,6490,10180
curE046a,31,Hard,1.0,right,2332,1466,3798,2,0,2,4,3,7,2,1,2,3,1974,392,764,1156
curE046a,32,Hard,1.0,right,17394,4048,21442,5,1,6,36,4,40,2,20,14,34,4092,8788,6248,15036
curE046a,33,xHard,0.0,left,3316,1666,4982,1,0,1,5,4,9,3,0,3,3,2646,0,782,782
curE046a,34,xHard,1.0,left,3978,1032,5010,2,1,3,9,3,12,1,2,5,7,1682,774,1626,2400
curE046a,35,xHard,0.0,left,4948,1116,6064,2,1,3,11,3,14,1,3,5,8,1624,954,2334,3288
curE046a,36,xHard,0.0,right,7576,1532,9108,3,0,3,12,3,15,2,3,6,9,1784,996,2194,3190
curE046a,37,Hard,0.0,right,2464,2316,4780,2,0,2,4,5,9,4,1,2,3,2286,812,1012,1824
curE046a,38,Hard,0.0,right,2664,1184,3848,1,0,1,4,3,7,2,0,1,1,2188,0,456,456
curE046a,41,Medium,0.0,left,4714,650,5364,2,1,3,11,2,13,0,1,8,9,1226,518,2512,3030
curE046a,44,Easy,0.0,right,3198,1616,4814,1,0,1,6,4,10,3,0,4,4,2672,0,1380,1380
curE049a,7,Easy,1.0,left,4664,568,5232,2,1,3,9,2,11,0,3,5,8,436,1736,1766,3502
curE049a,8,Easy,1.0,left,2332,4816,7148,1,2,3,3,10,13,8,0,2,2,3320,0,494,494
curE049a,9,Medium,0.0,right,6998,1834,8832,2,1,3,21,4,25,2,16,2,18,764,4210,338,4548
curE049a,10,Medium,1.0,right,19276,1834,21110,2,1,3,51,5,56,3,31,18,49,1368,9992,6290,16282
curE049a,11,Medium,0.0,right,5130,1850,6980,2,1,3,11,4,15,3,8,2,10,1474,3420,528,3948
curE049a,12,Medium,1.0,right,6830,1200,8030,4,0,4,17,3,20,2,7,8,15,1146,2132,2134,4266
curE049a,15,Medium,0.0,left,2948,3982,6930,1,1,2,4,8,12,7,3,0,3,3562,738,0,738
curE049a,16,Medium,0.0,right,12046,1766,13812,2,1,3,31,6,37,4,20,10,30,1544,4060,2172,6232
curE049a,18,Easy,1.0,right,2616,1766,4382,2,0,2,7,5,12,4,4,2,6,1520,628,780,1408
curE049a,19,Easy,0.0,right,9710,1666,11376,3,1,4,24,2,26,1,8,15,23,346,1706,5220,6926
curE049a,20,Easy,1.0,right,4464,7964,12428,2,0,2,11,4,15,4,6,4,10,1744,1380,1574,2954
curE049a,25,Easy,1.0,right,4914,2550,7464,3,0,3,11,6,17,5,6,3,9,2736,2144,1036,3180
curE049a,26,Medium,1.0,right,4648,1632,6280,2,0,2,13,4,17,2,5,5,10,1134,1916,1148,3064
curE049a,27,Medium,1.0,left,14512,2582,17094,4,1,5,34,8,42,6,20,11,31,2372,5512,2166,7678
curE049a,29,Hard,1.0,left,3898,5816,9714,2,0,2,10,8,18,5,6,3,9,1740,1588,1274,2862
curE049a,31,Hard,1.0,right,12408,7932,20340,2,0,2,17,10,27,9,7,8,15,5078,2220,1762,3982
curE049a,32,Hard,1.0,right,3526,1618,5144,1,1,2,5,4,9,2,1,3,4,1114,200,1828,2028
curE049a,34,xHard,0.0,right,4864,1634,6498,2,0,2,13,4,17,3,4,8,12,1630,872,2018,2890
curE049a,53,xHard,1.0,right,15158,4316,19474,1,0,1,24,4,28,4,1,20,21,1190,176,4298,4474
curE049a,54,xHard,0.0,right,9776,1266,11042,2,0,2,18,2,20,2,2,14,16,800,332,3518,3850
curE049a,55,xHard,0.0,left,18694,1516,20210,2,1,3,19,4,23,3,11,7,18,1306,2884,1798,4682
curE050a,7,Easy,1.0,right,2448,2816,5264,2,1,3,5,6,11,5,1,3,4,2742,244,1430,1674
curE050a,8,Easy,0.0,left,2332,5698,8030,1,1,2,4,8,12,7,0,2,2,4106,0,272,272
curE050a,9,Easy,1.0,right,2648,2100,4748,1,0,1,5,4,9,4,1,3,4,1234,332,1080,1412
curE050a,12,Easy,1.0,right,3316,1666,4982,2,0,2,8,4,12,3,2,4,6,1730,402,1822,2224
curE050a,13,Easy,0.0,right,2626,1616,4242,2,1,3,5,5,10,3,2,2,4,1558,542,860,1402
curE050a,15,Easy,0.0,right,3208,1166,4374,2,0,2,9,3,12,2,2,5,7,1658,460,1174,1634
curE050a,16,Easy,0.0,left,2330,1366,3696,1,0,1,5,4,9,3,2,2,4,1658,542,530,1072
curE050a,17,Easy,0.0,right,2330,1632,3962,1,0,1,3,5,8,3,0,2,2,2396,26,608,634
curE050a,18,Easy,0.0,right,2328,1182,3510,1,0,1,4,3,7,2,1,2,3,1798,248,394,642
curE050a,19,Easy,0.0,right,2330,1682,4012,1,0,1,4,3,7,3,2,1,3,1172,724,446,1170
curE050a,20,Easy,1.0,right,2332,3848,6180,2,1,3,4,9,13,7,1,2,3,2948,140,992,1132
curE050a,22,Easy,0.0,right,2330,1066,3396,1,1,2,5,3,8,2,2,2,4,1614,368,444,812
curE050a,23,Easy,0.0,left,3312,3832,7144,1,0,1,6,10,16,9,4,1,5,3664,1932,240,2172
curE050a,24,Easy,1.0,left,2648,1716,4364,1,1,2,5,5,10,3,2,2,4,1036,776,466,1242
curE050a,25,Easy,1.0,left,2330,2432,4762,1,0,1,5,3,8,3,3,1,4,1292,1016,166,1182
curE050a,26,Medium,0.0,right,4448,2066,6514,1,0,1,4,3,7,2,0,2,2,2316,0,1288,1288
curE050a,27,Medium,1.0,right,5046,1100,6146,1,1,2,3,2,5,1,0,2,2,1036,0,594,594
curE050a,28,Medium,0.0,right,12222,2740,14962,2,0,2,20,4,24,3,4,13,17,2704,2404,4442,6846
curE050a,31,Medium,1.0,right,11528,1534,13062,2,0,2,13,0,13,0,11,0,11,410,1590,0,1590
curE050a,34,Medium,1.0,right,3916,2216,6132,3,0,3,12,5,17,4,5,6,11,2146,1462,1516,2978
curE050a,37,Hard,0.0,right,4998,9730,14728,3,0,3,11,10,21,8,4,4,8,3852,1634,1208,2842
curE050a,38,Hard,0.0,right,5342,1350,6692,2,1,3,6,3,9,2,0,3,3,1296,0,1126,1126
curE051a,7,Easy,0.0,right,8998,2930,11928,1,0,1,15,9,24,8,8,5,13,2944,3048,1674,4722
curE051a,8,Easy,1.0,left,5364,566,5930,2,1,3,13,1,14,0,4,8,12,534,1624,2908,4532
curE051a,9,Easy,0.0,left,5548,2650,8198,2,1,3,14,5,19,4,9,4,13,2592,3396,1238,4634
curE051a,11,Easy,0.0,right,12196,4464,16660,2,1,3,15,9,24,7,10,4,14,3778,2846,948,3794
curE051a,12,Easy,0.0,left,19492,5066,24558,4,1,5,30,3,33,2,16,13,29,1178,4892,3224,8116
curE051a,14,Easy,0.0,right,4998,4698,9696,1,0,1,2,2,4,1,0,1,1,272,0,200,200
curE051a,15,Easy,1.0,right,7580,1934,9514,2,0,2,10,0,10,0,5,4,9,130,1244,850,2094
curE051a,16,Easy,1.0,left,13874,2650,16524,1,0,1,7,2,9,2,5,1,6,372,710,214,924
curE051a,19,Medium,0.0,left,6614,2584,9198,1,0,1,3,5,8,4,1,2,3,842,156,320,476
curE051a,21,Medium,0.0,left,7830,1732,9562,1,0,1,5,2,7,2,5,0,5,346,852,0,852
curE051a,22,Medium,0.0,left,6156,1924,8080,1,0,1,10,0,10,0,8,0,8,326,1584,0,1584
curE051a,25,Easy,0.0,left,8864,2448,11312,3,2,5,19,7,26,5,12,5,17,2264,5986,1250,7236
curE051a,26,Easy,1.0,right,15802,7158,22960,3,2,5,23,11,34,8,12,7,19,4300,4300,3282,7582
curE051a,27,Easy,0.0,right,15108,1866,16974,3,0,3,25,5,30,4,19,5,24,1710,6796,1202,7998
curE051a,30,Easy,0.0,right,8242,3914,12156,2,2,4,14,8,22,5,12,1,13,2920,2982,302,3284
curE051a,43,Medium,1.0,left,16722,5966,22688,3,1,4,40,16,56,14,11,21,32,6256,3866,8402,12268
curE051a,48,Hard,1.0,right,12158,10036,22194,2,1,3,18,13,31,12,14,2,16,6220,5556,600,6156
curE051a,50,Hard,0.0,left,9076,1748,10824,2,1,3,15,5,20,3,6,9,15,912,1642,3642,5284
curE051a,57,Hard,1.0,right,15110,1366,16476,4,0,4,26,3,29,2,13,11,24,1828,4990,5354,10344
curE052a,7,Easy,0.0,right,3712,2448,6160,3,0,3,9,6,15,5,5,3,8,2442,1670,1002,2672
curE052a,10,Easy,1.0,right,2516,1900,4416,2,0,2,6,4,10,3,3,2,5,1916,1066,574,1640
curE052a,11,Easy,1.0,right,2328,1166,3494,2,1,3,5,4,9,2,2,2,4,1560,506,568,1074
curE052a,12,Medium,1.0,right,7880,10038,17918,4,1,5,17,13,30,10,6,10,16,3888,1948,4176,6124
curE052a,14,Medium,1.0,right,2330,7066,9396,2,1,3,6,14,20,10,3,2,5,4090,1090,348,1438
curE052a,20,Medium,1.0,left,2744,1298,4042,2,0,2,8,3,11,2,2,5,7,1292,900,1082,1982
curE052a,22,Medium,0.0,right,7530,5582,13112,3,0,3,11,10,21,8,4,5,9,3810,1512,1996,3508
curE052a,23,Easy,1.0,right,4080,4050,8130,3,1,4,10,9,19,6,4,5,9,1984,1298,1880,3178
curE052a,24,Easy,1.0,left,18806,1616,20422,4,0,4,19,3,22,2,11,6,17,1554,5190,2668,7858
curE052a,25,Medium,1.0,right,4844,4398,9242,3,0,3,11,7,18,6,6,4,10,3098,2630,1346,3976
curE052a,26,Medium,1.0,right,6276,2682,8958,3,0,3,12,7,19,6,5,6,11,2644,2548,2340,4888
curE052a,27,Hard,0.0,right,16476,10038,26514,4,0,4,31,18,49,18,10,19,29,4620,3578,8342,11920
curE052a,32,Hard,1.0,right,13096,2898,15994,4,0,4,15,6,21,5,7,5,12,2748,1958,1390,3348
curE052a,33,xHard,0.0,right,3164,950,4114,3,1,4,7,2,9,1,4,2,6,900,1020,1126,2146
curE054a,7,Easy,1.0,right,8230,3500,11730,3,1,4,11,5,16,3,4,5,9,3190,1846,2162,4008
curE054a,8,Easy,0.0,left,4414,1966,6380,3,0,3,9,3,12,2,4,4,8,1964,1584,1610,3194
curE054a,9,Easy,0.0,right,7798,1432,9230,3,0,3,13,3,16,2,2,10,12,1436,592,5376,5968
curE054a,10,Easy,1.0,left,3814,2134,5948,3,0,3,9,5,14,3,4,4,8,1934,1550,1370,2920
curE054a,11,Easy,0.0,right,3948,2132,6080,3,1,4,10,6,16,4,4,5,9,2076,1772,1116,2888
curE054a,12,Easy,1.0,right,4542,2266,6808,3,0,3,11,5,16,4,5,5,10,1902,1694,1856,3550
curE054a,13,Easy,0.0,right,3062,1816,4878,2,0,2,6,4,10,3,2,3,5,1802,892,1416,2308
curE054a,16,Easy,1.0,right,2326,1634,3960,1,0,1,4,4,8,3,2,1,3,2376,796,150,946
curE054a,18,Medium,1.0,left,2566,3098,5664,2,0,2,6,7,13,6,2,3,5,2828,570,1092,1662
curE054a,19,Medium,1.0,right,5858,2416,8274,3,0,3,13,4,17,2,5,7,12,768,1638,2922,4560
curE054a,20,Hard,0.0,left,4462,1916,6378,3,1,4,8,4,12,2,3,4,7,1394,1952,1478,3430
curE054a,21,Hard,1.0,left,8256,1500,9756,3,0,3,6,4,10,3,2,3,5,1500,902,716,1618
curE054a,22,Hard,1.0,left,4716,1732,6448,3,0,3,9,4,13,3,4,4,8,1730,1690,1884,3574
curE054a,23,xHard,1.0,left,7370,1694,9064,3,0,3,17,5,22,4,9,6,15,1832,2676,1880,4556
curE054a,24,xHard,0.0,left,3764,1250,5014,2,0,2,6,3,9,2,4,1,5,1242,1242,296,1538
curE054a,36,Hard,0.0,left,3682,1798,5480,2,0,2,8,5,13,4,4,3,7,1742,1332,1138,2470
curE054a,41,Medium,0.0,left,2334,1382,3716,1,0,1,6,4,10,3,1,2,3,1392,272,380,652
curE054a,44,Medium,0.0,left,7798,1182,8980,4,0,4,13,3,16,2,5,6,11,1176,1852,3340,5192
curE054a,45,Medium,0.0,left,4626,1700,6326,3,0,3,9,4,13,3,4,4,8,1700,2284,1376,3660
curE054a,46,Easy,0.0,left,2330,1100,3430,2,1,3,5,3,8,1,3,1,4,1612,924,174,1098
curE054a,50,Easy,1.0,left,3312,1200,4512,2,0,2,6,3,9,2,2,2,4,1930,704,940,1644
curE054a,51,Easy,1.0,left,2326,1668,3994,2,0,2,6,4,10,3,2,3,5,1870,452,812,1264
curE054a,52,Medium,0.0,left,5862,1000,6862,2,1,3,5,3,8,1,2,1,3,1660,370,324,694
curE055a,7,Easy,0.0,left,3616,1514,5130,3,0,3,11,3,14,2,9,1,10,1248,2042,318,2360
curE055a,14,Easy,0.0,left,5260,3432,8692,3,0,3,14,7,21,6,9,3,12,3398,3402,718,4120
curE055a,16,Easy,0.0,right,6864,1000,7864,5,0,5,17,2,19,1,7,7,14,982,1958,2338,4296
curE055a,17,Easy,0.0,left,8364,2166,10530,3,0,3,17,3,20,2,3,13,16,892,790,3532,4322
curE055a,18,Easy,0.0,left,2332,1932,4264,2,0,2,7,4,11,3,4,2,6,1946,1056,508,1564
curE055a,19,Easy,1.0,left,4782,3098,7880,2,1,3,12,6,18,4,3,7,10,2612,676,2998,3674
curE055a,20,Easy,0.0,left,3928,1216,5144,3,0,3,9,3,12,2,4,4,8,1184,1570,1366,2936
curE055a,27,Easy,0.0,right,4102,1944,6046,1,2,3,10,4,14,2,7,0,7,1812,2622,0,2622
curE055a,29,Easy,0.0,left,2898,2116,5014,1,1,2,3,6,9,3,1,1,2,1232,630,174,804
curE055a,31,Easy,1.0,left,2330,1466,3796,1,1,2,3,4,7,2,2,0,2,736,756,0,756
curE055a,32,Easy,1.0,left,2460,632,3092,1,1,2,5,2,7,0,4,0,4,534,1774,0,1774
curE055a,36,Medium,0.0,left,2326,1950,4276,2,1,3,5,4,9,2,3,1,4,2160,1042,198,1240
curE055a,44,Medium,1.0,left,3630,1834,5464,2,0,2,8,3,11,2,1,4,5,922,230,1510,1740
curE055a,46,Hard,0.0,left,5514,2616,8130,3,0,3,13,3,16,2,2,9,11,2566,318,3802,4120
curE055a,49,Medium,0.0,right,14376,1234,15610,3,1,4,23,2,25,1,19,3,22,694,6968,848,7816
curE055a,50,Medium,0.0,right,2332,1998,4330,2,0,2,6,3,9,2,3,2,5,1988,852,542,1394
curE055a,54,Easy,0.0,left,2650,932,3582,1,1,2,4,3,7,1,0,2,2,1326,0,434,434
curE055a,55,Easy,0.0,right,5230,1548,6778,2,0,2,6,4,10,3,3,2,5,1534,1446,822,2268
curE055a,59,Easy,1.0,left,16728,1166,17894,9,1,10,31,4,35,2,13,17,30,1076,5042,5842,10884
curE055a,60,Medium,0.0,right,2330,1150,3480,2,0,2,5,3,8,2,1,2,3,1760,118,594,712
curE056a,7,Easy,1.0,left,4978,1950,6928,2,1,3,12,4,16,3,7,4,11,1898,2828,1342,4170
curE056a,8,Easy,1.0,left,3932,1584,5516,3,0,3,10,4,14,3,4,4,8,1848,1710,1128,2838
curE056a,10,Medium,0.0,left,8880,2166,11046,4,0,4,18,5,23,3,5,12,17,1792,2298,4890,7188
curE056a,11,Medium,1.0,right,4132,1566,5698,2,0,2,8,4,12,3,2,4,6,2144,502,1976,2478
curE056a,12,Medium,0.0,left,4932,1998,6930,1,0,1,11,3,14,2,7,0,7,1822,1812,0,1812
curE056a,13,Medium,1.0,left,5928,1266,7194,1,0,1,8,3,11,2,7,0,7,1268,3500,0,3500
curE056a,14,Medium,0.0,left,2780,1734,4514,1,1,2,7,3,10,1,3,3,6,1696,970,1058,2028
curE056a,20,Easy,1.0,left,2332,1784,4116,2,0,2,5,3,8,2,1,3,4,1848,592,1012,1604
curE056a,21,Easy,0.0,left,2332,1066,3398,1,1,2,4,3,7,1,3,0,3,1838,782,0,782
curE056a,22,Easy,1.0,left,10712,2334,13046,4,0,4,19,3,22,2,8,10,18,1434,3030,5206,8236
curE056a,23,Easy,1.0,left,3064,1350,4414,2,1,3,5,3,8,1,1,2,3,2400,570,624,1194
curE056a,24,Medium,0.0,left,3748,2134,5882,2,0,2,6,5,11,4,4,1,5,2112,2082,374,2456
curE056a,28,Medium,1.0,left,2414,10038,12452,2,0,2,4,2,6,2,1,1,2,1374,574,498,1072
curE056a,30,Medium,0.0,left,3198,932,4130,3,1,4,9,3,12,1,4,2,6,1236,1272,446,1718
curE056a,38,Easy,0.0,left,12862,5080,17942,1,0,1,11,8,19,8,9,1,10,3014,5024,774,5798
curE056a,40,Easy,1.0,left,4532,4232,8764,1,1,2,3,5,8,3,2,0,2,2414,1014,0,1014
curE056a,43,Easy,0.0,left,6964,3050,10014,3,0,3,13,5,18,4,6,6,12,3056,2460,1588,4048
curE058a,11,Easy,1.0,right,6646,584,7230,1,1,2,12,2,14,0,0,8,8,794,0,4298,4298
curE058a,13,Easy,1.0,right,13462,1066,14528,1,0,1,31,2,33,1,4,25,29,1096,964,9938,10902
curE058a,15,Medium,1.0,right,3248,1550,4798,2,1,3,8,3,11,1,2,4,6,1994,666,1298,1964
curE058a,18,Hard,0.0,right,4732,3432,8164,2,1,3,10,6,16,2,4,4,8,2990,1854,1054,2908
curE058a,19,Medium,0.0,left,3482,10038,13520,1,0,1,7,23,30,22,0,2,2,5810,0,816,816
curE058a,21,Medium,1.0,left,2332,1750,4082,0,0,0,7,5,12,3,0,2,2,2226,0,308,308
curE058a,23,Hard,0.0,right,2412,2050,4462,0,0,0,1,0,1,0,0,0,0,100,0,0,0
curE058a,31,Medium,0.0,left,9494,616,10110,2,1,3,21,1,22,0,11,8,19,370,4522,2410,6932
curE058a,32,Medium,1.0,left,6464,10038,16502,1,0,1,6,14,20,14,0,3,3,5488,0,1060,1060
curE058a,40,Medium,1.0,right,7380,8396,15776,3,0,3,17,10,27,9,6,9,15,4506,1954,3342,5296
curE058a,45,Medium,1.0,right,3348,10040,13388,2,0,2,5,6,11,6,3,1,4,2658,910,628,1538
curE058a,46,Medium,0.0,right,14276,3598,17874,3,2,5,21,10,31,6,6,12,18,2358,1908,6092,8000
curE058a,48,Easy,0.0,right,3032,4232,7264,2,1,3,7,8,15,7,3,2,5,3352,610,588,1198
curE062a,7,Easy,0.0,right,3082,7766,10848,2,2,4,7,13,20,10,3,2,5,6990,886,1398,2284
curE062a,8,Easy,0.0,right,5064,7864,12928,3,1,4,11,15,26,12,6,4,10,5778,2236,1670,3906
curE062a,11,Easy,1.0,left,16594,4298,20892,5,0,5,28,3,31,3,14,12,26,708,4068,5674,9742
curE062a,12,Easy,1.0,right,2332,1934,4266,2,0,2,7,5,12,4,2,3,5,1392,480,898,1378
curE062a,13,Medium,0.0,left,7846,1416,9262,5,0,5,14,3,17,2,9,4,13,1412,5326,1110,6436
curE062a,14,Medium,0.0,left,2332,600,2932,2,1,3,4,2,6,0,1,2,3,546,176,1318,1494
curE062a,15,Easy,1.0,left,5126,1234,6360,3,0,3,12,3,15,2,6,4,10,1098,2710,1362,4072
curE062a,16,Easy,1.0,right,5282,566,5848,2,1,3,9,2,11,0,5,3,8,540,3630,740,4370
curE062a,17,Medium,0.0,left,3830,9898,13728,3,3,6,11,15,26,9,5,5,10,5854,1642,1326,2968
curE062a,22,Medium,1.0,right,3128,1750,4878,3,1,4,7,5,12,3,3,1,4,2044,1546,202,1748
curE062a,23,Medium,1.0,right,3762,6198,9960,3,1,4,9,12,21,11,4,4,8,4670,1294,1322,2616
curE062a,24,Hard,0.0,right,5564,1468,7032,3,0,3,15,4,19,3,7,5,12,1396,1822,2204,4026
curE062a,25,Hard,0.0,left,11928,5362,17290,4,1,5,18,7,25,5,7,10,17,2418,1990,3364,5354
curE062a,27,Medium,1.0,left,5214,4198,9412,3,1,4,7,7,14,6,2,4,6,3932,888,1156,2044
curE062a,29,Hard,0.0,left,3814,9382,13196,2,1,3,11,16,27,14,5,2,7,8112,1502,542,2044
curE063a,7,Easy,1.0,left,7912,1466,9378,7,0,7,17,3,20,2,3,11,14,2166,1182,4724,5906
curE063a,8,Easy,1.0,right,3740,1640,5380,2,1,3,7,5,12,2,3,1,4,1472,1394,876,2270
curE063a,9,Medium,1.0,right,11018,3010,14028,8,1,9,24,7,31,5,9,11,20,2888,3674,5296,8970
curE063a,10,Medium,1.0,right,2728,1566,4294,2,0,2,5,4,9,3,2,2,4,1470,1318,448,1766
curE063a,11,Hard,0.0,right,11690,2216,13906,5,0,5,22,4,26,3,9,12,21,2218,3526,5276,8802
curE063a,12,Hard,1.0,right,18496,5062,23558,3,1,4,23,3,26,2,4,17,21,1466,808,8326,9134
curE063a,17,Hard,0.0,right,2330,1232,3562,2,0,2,6,3,9,2,2,2,4,1476,618,358,976
curE063a,20,Hard,1.0,right,3848,1534,5382,2,1,3,8,1,9,0,3,3,6,422,1054,1454,2508
curE063a,21,Hard,1.0,left,4212,3966,8178,4,0,4,12,8,20,5,5,4,9,2722,1502,1412,2914
curE063a,22,xHard,0.0,left,10730,1550,12280,3,1,4,11,4,15,2,7,4,11,964,2674,1040,3714
curE063a,23,xHard,1.0,left,10646,1550,12196,3,1,4,15,3,18,1,6,6,12,1518,2950,3634,6584
curE063a,24,xHard,0.0,right,4498,1700,6198,4,1,5,12,4,16,3,6,4,10,1588,1994,1356,3350
curE063a,25,xHard,1.0,left,2680,2348,5028,2,0,2,7,4,11,3,3,2,5,1498,1182,676,1858
curE063a,29,xHard,0.0,right,12346,1966,14312,4,1,5,12,3,15,2,4,5,9,1870,1832,2768,4600
curE063a,34,xHard,0.0,left,11494,10038,21532,3,0,3,19,0,19,0,9,8,17,356,2132,2574,4706
curE063a,37,xHard,0.0,right,3498,1416,4914,1,0,1,5,3,8,2,0,3,3,1336,0,1184,1184
curE063a,38,Hard,0.0,left,15704,1718,17422,3,1,4,15,5,20,3,8,4,12,1426,3142,1378,4520
curE066a,8,Easy,0.0,right,2362,1366,3728,1,0,1,2,3,5,2,0,1,1,1182,0,104,104
curE066a,9,Easy,1.0,right,2398,1788,4186,2,0,2,8,4,12,3,4,3,7,1560,870,834,1704
curE066a,10,Easy,1.0,right,5098,1698,6796,2,1,3,13,6,19,4,10,2,12,1554,2740,698,3438
curE066a,15,Medium,0.0,right,7482,3014,10496,3,1,4,13,7,20,4,7,5,12,2270,2090,1968,4058
curE066a,16,Easy,0.0,right,10396,1832,12228,1,0,1,14,0,14,0,1,12,13,536,196,5028,5224
curE066a,21,Medium,1.0,right,3564,1416,4980,2,0,2,8,2,10,1,3,4,7,752,872,1442,2314
curE066a,22,Medium,0.0,left,7780,6298,14078,2,1,3,20,13,33,11,16,2,18,4274,4830,476,5306
curE066a,23,Medium,1.0,left,16044,4600,20644,3,1,4,22,8,30,6,12,9,21,3908,3808,2814,6622
curE066a,24,Medium,0.0,right,12912,2232,15144,1,1,2,14,6,20,4,0,12,12,1768,0,2864,2864
curE066a,25,Medium,0.0,right,2566,568,3134,1,1,2,3,2,5,0,1,1,2,444,1236,200,1436
curE066a,26,Easy,0.0,left,4278,1182,5460,3,1,4,11,4,15,2,5,5,10,1134,1528,1724,3252
curE066a,27,Easy,1.0,right,3864,1416,5280,1,1,2,5,4,9,2,2,1,3,1594,412,146,558
curE066a,31,Easy,1.0,left,2332,1782,4114,1,0,1,4,2,6,1,3,0,3,1496,398,0,398
curE066a,32,Easy,1.0,left,2764,1066,3830,2,1,3,7,3,10,1,2,4,6,1018,798,1172,1970
curE066a,33,Medium,1.0,left,4114,1350,5464,0,1,1,1,4,5,3,0,0,0,996,0,0,0
curE066a,34,Medium,0.0,left,9496,1466,10962,5,0,5,18,0,18,0,10,6,16,448,4416,1862,6278
curE066a,39,Easy,1.0,right,2750,932,3682,2,1,3,8,2,10,1,2,1,3,1928,498,256,754
curE066a,40,Easy,1.0,right,4286,1694,5980,3,0,3,9,5,14,4,1,4,5,1766,338,1290,1628
curE067a,9,Easy,1.0,left,2332,1832,4164,1,0,1,5,4,9,3,3,0,3,2074,1382,0,1382
curE067a,10,Easy,1.0,left,4998,2332,7330,3,0,3,12,4,16,3,6,5,11,2304,2490,1470,3960
curE067a,13,Medium,1.0,left,5464,1832,7296,5,1,6,12,5,17,3,6,4,10,1244,2520,1716,4236
curE067a,14,Medium,1.0,left,13944,1334,15278,4,0,4,22,3,25,2,6,13,19,1336,2422,6392,8814
curE067a,17,Hard,0.0,left,3778,1748,5526,3,1,4,10,4,14,2,2,7,9,1688,832,2088,2920
curE067a,18,Hard,1.0,right,14028,3916,17944,5,0,5,26,6,32,5,16,10,26,3006,6232,5346,11578
curE067a,19,Hard,0.0,left,7848,9680,17528,5,1,6,21,11,32,8,11,9,20,4408,3784,2684,6468
curE067a,21,Hard,0.0,left,2962,10036,12998,2,0,2,6,10,16,9,2,3,5,5428,652,1192,1844
curE067a,22,Hard,1.0,left,7310,3284,10594,5,0,5,13,0,13,0,7,5,12,344,2160,2648,4808
curE067a,30,xHard,1.0,left,2332,3532,5864,2,0,2,4,3,7,2,2,1,3,4168,464,556,1020
curE067a,40,xHard,0.0,left,2816,2032,4848,2,0,2,4,3,7,2,1,1,2,1428,364,786,1150
curE067a,45,Hard,0.0,left,5160,3234,8394,2,0,2,12,5,17,4,4,7,11,2700,1416,2672,4088
curE067a,57,xHard,0.0,left,2832,1250,4082,2,0,2,7,3,10,2,3,2,5,1206,1428,624,2052
curE070a,9,Easy,1.0,right,7030,2934,9964,3,0,3,19,5,24,4,5,13,18,2910,2242,3498,5740
curE070a,10,Easy,1.0,left,8148,3482,11630,4,1,5,18,7,25,5,7,10,17,2548,2702,4034,6736
curE070a,11,Medium,0.0,left,6444,1784,8228,4,0,4,16,4,20,3,7,8,15,1778,2098,3078,5176
curE070a,12,Medium,0.0,right,3832,1898,5730,3,0,3,9,5,14,4,4,4,8,1890,1386,1590,2976
curE070a,13,Easy,0.0,left,5880,1466,7346,2,0,2,10,4,14,3,3,6,9,1452,816,4258,5074
curE070a,14,Easy,0.0,right,4432,1682,6114,3,0,3,12,3,15,2,6,5,11,1586,2122,1352,3474
curE070a,15,Easy,0.0,left,5610,3266,8876,3,0,3,16,8,24,7,11,4,15,3268,2914,1364,4278
curE070a,16,Easy,1.0,left,5264,1266,6530,2,1,3,9,3,12,1,3,1,4,686,1906,932,2838
curE070a,17,Easy,1.0,left,4464,1900,6364,1,1,2,5,5,10,4,0,4,4,1490,0,2388,2388
curE070a,18,Medium,0.0,left,4748,1666,6414,2,0,2,6,5,11,4,4,1,5,1360,706,398,1104
curE070a,21,Medium,1.0,right,7946,6582,14528,6,0,6,16,8,24,7,8,7,15,2886,4478,1750,6228
curE070a,22,Hard,0.0,left,3728,1800,5528,2,0,2,10,4,14,3,4,5,9,1696,1222,1712,2934
curE070a,23,Hard,0.0,left,3816,2766,6582,3,1,4,9,7,16,5,5,3,8,2540,1558,1366,2924
curE070a,24,Medium,1.0,left,3948,1700,5648,2,0,2,7,4,11,3,1,5,6,1392,164,1212,1376
curE070a,25,Medium,0.0,left,2332,2266,4598,2,0,2,5,5,10,4,2,2,4,2360,816,650,1466
curE070a,35,Easy,1.0,right,4414,6148,10562,2,0,2,5,8,13,6,2,1,3,5440,664,150,814
curE070a,36,Easy,1.0,right,5764,10038,15802,3,0,3,13,0,13,0,5,7,12,430,2170,2578,4748
curE071a,10,Easy,1.0,left,11646,10038,21684,3,0,3,19,0,19,0,9,10,19,0,2494,2316,4810
curE071a,11,Easy,0.0,left,17144,7480,24624,3,0,3,26,8,34,7,20,4,24,3418,6348,1272,7620
curE071a,18,Easy,0.0,right,15976,4632,20608,1,0,1,11,2,13,2,0,10,10,1002,0,2824,2824
curE071a,21,Easy,0.0,right,3980,2066,6046,2,1,3,8,1,9,0,2,5,7,246,1122,2006,3128
curE071a,24,Easy,0.0,left,2326,3066,5392,1,0,1,5,5,10,4,0,3,3,2336,0,836,836
curE071a,27,Easy,1.0,left,3232,1998,5230,2,1,3,5,4,9,3,2,2,4,1606,734,818,1552
curE071a,31,Medium,0.0,right,2864,2966,5830,1,0,1,6,7,13,6,0,3,3,2258,0,784,784
curE071a,32,Medium,0.0,right,4764,10038,14802,2,1,3,7,11,18,10,3,3,6,3046,1000,826,1826
curE071a,33,Easy,0.0,left,9344,10038,19382,1,0,1,2,4,6,4,0,2,2,728,0,400,400
curE071a,34,Easy,1.0,right,10308,1716,12024,2,0,2,12,3,15,2,5,6,11,1048,1064,1532,2596
curE071a,35,Easy,1.0,right,2330,700,3030,1,1,2,3,3,6,1,0,2,2,708,52,452,504
curE071a,44,Medium,1.0,right,5194,8146,13340,1,0,1,8,14,22,12,4,3,7,4638,776,1090,1866
curE071a,47,Medium,0.0,right,4314,1816,6130,3,0,3,8,6,14,4,4,3,7,1490,1340,1068,2408
curE072a,7,Easy,1.0,left,3098,968,4066,2,0,2,6,2,8,1,1,2,3,1754,638,556,1194
curE072a,9,Easy,0.0,left,3516,1216,4732,2,1,3,9,4,13,2,5,1,6,1712,1412,486,1898
curE072a,11,Easy,0.0,left,2332,2416,4748,2,2,4,6,7,13,4,2,2,4,1698,470,902,1372
curE072a,13,Easy,0.0,left,3282,1318,4600,2,0,2,8,3,11,2,3,4,7,1310,1016,1210,2226
curE072a,14,Easy,1.0,left,8364,1400,9764,3,1,4,18,1,19,0,4,13,17,0,1256,5112,6368
curE072a,15,Easy,1.0,left,16290,1450,17740,1,1,2,23,6,29,4,20,0,20,1350,6914,0,6914
curE072a,17,Medium,1.0,left,3230,1366,4596,1,0,1,5,3,8,2,0,3,3,1354,0,1362,1362
curE072a,18,Medium,0.0,left,7730,1366,9096,3,0,3,12,2,14,2,3,8,11,1060,1376,2914,4290
curE072a,23,Medium,1.0,left,2330,1202,3532,1,0,1,5,3,8,2,0,2,2,1736,0,912,912
curE072a,24,Medium,1.0,left,2332,982,3314,2,1,3,5,3,8,1,2,2,4,1028,424,692,1116
curE072a,26,Hard,1.0,left,11062,1482,12544,6,1,7,21,2,23,1,9,9,18,516,3658,4638,8296
curE072a,31,Hard,0.0,right,10496,1300,11796,2,0,2,18,3,21,2,13,4,17,756,6632,1016,7648
curE072a,32,Hard,1.0,right,10158,568,10726,4,1,5,19,2,21,0,4,13,17,294,1364,4158,5522
curE072a,34,Hard,0.0,left,2666,950,3616,1,1,2,5,3,8,1,2,0,2,1366,1158,0,1158
curE072a,40,Hard,0.0,left,2332,2766,5098,1,0,1,4,7,11,6,0,3,3,3464,0,926,926
curE072a,46,Hard,0.0,left,2862,1132,3994,2,1,3,7,3,10,2,2,1,3,1964,680,238,918
curE072a,47,Hard,0.0,left,10228,6500,16728,1,1,2,10,8,18,6,0,9,9,2154,0,1398,1398
curE072a,48,Medium,1.0,left,12792,1632,14424,7,0,7,18,3,21,2,4,11,15,1394,1826,4698,6524
curE074a,11,Easy,1.0,right,2414,1250,3664,2,1,3,4,3,7,1,1,2,3,984,482,1148,1630
curE074a,12,Easy,0.0,right,8246,1750,9996,2,1,3,17,3,20,2,2,13,15,1768,1758,5432,7190
curE074a,14,Easy,0.0,right,8360,2566,10926,3,0,3,19,6,25,5,15,3,18,2292,5758,1314,7072
curE074a,15,Easy,1.0,right,11128,1734,12862,4,0,4,19,3,22,2,3,14,17,1908,948,8390,9338
curE074a,16,Easy,1.0,right,6798,2032,8830,3,1,4,14,4,18,2,3,10,13,1694,1648,3808,5456
curE074a,19,Medium,0.0,right,4700,2014,6714,2,1,3,11,4,15,2,3,6,9,2020,812,2744,3556
curE074a,20,Easy,1.0,right,2714,1634,4348,2,0,2,7,4,11,3,1,4,5,1578,464,1424,1888
curE074a,21,Easy,0.0,right,4282,1434,5716,2,1,3,8,4,12,2,1,6,7,1370,578,2808,3386
curE074a,24,Easy,1.0,right,2632,1566,4198,2,1,3,7,4,11,3,4,2,6,1514,1130,574,1704
curE074a,26,Easy,1.0,right,7712,1416,9128,4,1,5,10,4,14,2,4,5,9,822,2498,2788,5286
curE074a,28,Easy,0.0,right,2330,1484,3814,2,0,2,4,4,8,3,1,2,3,2158,356,484,840
curE074a,30,Easy,1.0,right,2330,1432,3762,2,0,2,7,4,11,3,1,4,5,1510,484,900,1384
curE074a,31,Easy,0.0,right,2332,1350,3682,2,0,2,4,3,7,2,2,1,3,2050,556,408,964
curE074a,32,Easy,0.0,right,2332,1400,3732,2,1,3,5,4,9,2,1,3,4,1734,494,520,1014
curE074a,34,Easy,1.0,right,2550,1416,3966,2,1,3,6,3,9,2,3,2,5,1376,1034,692,1726
curE074a,36,Easy,0.0,right,2416,1332,3748,2,1,3,7,3,10,1,2,4,6,1298,636,1034,1670
curE074a,37,Easy,0.0,left,2326,10038,12364,2,0,2,4,0,4,0,1,2,3,1012,142,604,746
curE074a,45,Medium,1.0,right,5848,1700,7548,2,0,2,8,4,12,2,3,4,7,1312,1326,3422,4748
curE074a,51,Medium,0.0,right,4948,10038,14986,2,0,2,7,10,17,10,2,3,5,2766,420,1934,2354
curE074a,52,Easy,1.0,right,4564,9380,13944,2,1,3,6,7,13,5,3,2,5,3966,684,696,1380
curE074a,56,Easy,0.0,left,2326,1218,3544,1,1,2,5,1,6,0,0,2,2,1188,0,670,670
curE075a,7,Easy,0.0,left,2478,2708,5186,2,1,3,7,6,13,4,2,3,5,2336,598,732,1330
curE075a,16,Easy,0.0,left,9698,1414,11112,3,0,3,15,3,18,2,7,8,15,876,2748,4172,6920
curE075a,17,Easy,0.0,left,3076,1450,4526,2,0,2,8,3,11,2,5,2,7,1452,1610,720,2330
curE075a,18,Easy,1.0,left,2944,4732,7676,2,1,3,7,5,12,4,4,2,6,1464,1586,584,2170
curE075a,21,Easy,0.0,left,9374,6398,15772,5,1,6,19,15,34,11,11,6,17,5130,3472,1472,4944
curE075a,22,Easy,1.0,left,2814,1182,3996,3,0,3,7,3,10,2,3,3,6,1176,950,874,1824
curE075a,23,Easy,1.0,left,2332,682,3014,1,1,2,4,2,6,0,3,0,3,1098,1208,0,1208
curE075a,24,Medium,1.0,left,8998,4114,13112,4,1,5,15,9,24,7,9,5,14,3730,2320,1322,3642
curE075a,25,Medium,0.0,left,2326,1800,4126,1,0,1,5,4,9,3,3,0,3,2502,790,0,790
curE075a,29,Easy,1.0,left,2932,2350,5282,2,0,2,8,5,13,4,5,2,7,2344,1356,816,2172
curE075a,30,Easy,1.0,right,4024,10298,14322,2,0,2,10,22,32,16,4,3,7,8608,1048,1082,2130
curE075a,31,Medium,1.0,left,2414,1598,4012,1,1,2,6,4,10,2,0,5,5,1266,0,1836,1836
curE075a,32,Medium,0.0,right,2498,1284,3782,2,0,2,6,4,10,2,2,2,4,1232,520,808,1328
curE075a,33,Medium,1.0,left,2810,5032,7842,3,1,4,7,11,18,9,1,4,5,4284,362,1350,1712
curE075a,34,Medium,0.0,left,4960,1966,6926,2,0,2,11,5,16,4,8,2,10,1650,2532,612,3144
curE075a,35,Medium,0.0,left,7780,2550,10330,3,0,3,13,3,16,2,6,6,12,2516,2474,3852,6326
curE075a,43,Easy,1.0,left,6708,5932,12640,2,0,2,12,9,21,8,1,8,9,5546,508,4588,5096
curE075a,44,Easy,1.0,right,8562,10038,18600,6,0,6,22,17,39,15,11,8,19,7238,3156,3788,6944
curE075a,46,Medium,0.0,left,4626,5180,9806,3,1,4,14,12,26,11,5,8,13,4826,1304,2310,3614
curE075a,47,Medium,1.0,left,2410,10038,12448,1,0,1,5,0,5,0,4,0,4,536,1564,0,1564
curE075a,49,Medium,1.0,left,2700,3148,5848,2,0,2,7,6,13,5,2,3,5,2876,530,1190,1720
curE075a,60,Easy,0.0,left,4232,2050,6282,2,1,3,10,5,15,4,2,7,9,1648,434,2888,3322
curE075a,61,Easy,1.0,left,15022,1568,16590,2,0,2,21,2,23,1,1,18,19,546,140,9064,9204
curE075a,62,Easy,0.0,right,3426,10038,13464,2,0,2,5,18,23,16,3,1,4,6512,2256,430,2686
curE075a,64,Easy,1.0,right,13556,1266,14822,4,0,4,25,4,29,2,18,4,22,812,9794,1852,11646
curE075a,65,Easy,1.0,right,2332,1918,4250,1,0,1,4,4,8,3,0,3,3,1904,0,1522,1522
curE075a,69,Hard,0.0,left,20258,1982,22240,7,0,7,29,3,32,2,18,10,28,1964,8250,3688,11938
curE075a,70,Hard,1.0,left,5376,2232,7608,2,0,2,7,6,13,5,4,2,6,2070,1484,628,2112
curE075a,73,Hard,1.0,left,10380,10038,20418,6,0,6,19,1,20,1,11,6,17,254,5140,2974,8114
curE075a,75,Hard,0.0,left,3080,3064,6144,2,1,3,7,3,10,2,2,4,6,2486,386,2036,2422
curE075a,76,Hard,1.0,left,4512,1466,5978,1,0,1,7,4,11,3,4,2,6,1454,2404,792,3196
curE075a,80,xHard,0.0,left,2332,1516,3848,2,0,2,5,3,8,2,2,1,3,1962,330,606,936
curE075a,81,xHard,0.0,right,3682,4548,8230,2,1,3,9,10,19,8,4,4,8,3966,1518,1174,2692
curE075a,82,Hard,1.0,right,15758,2134,17892,5,1,6,39,6,45,4,26,12,38,2084,9798,4218,14016
curE075a,83,Hard,0.0,left,2432,2066,4498,2,0,2,7,5,12,4,1,5,6,2074,194,1408,1602
curE075a,84,Hard,1.0,left,9996,1584,11580,3,0,3,9,2,11,2,4,4,8,1036,1078,2458,3536
curE075a,85,Hard,1.0,left,3600,3466,7066,2,1,3,9,8,17,6,4,4,8,3394,1298,1510,2808
curE075a,86,xHard,1.0,left,3982,2498,6480,3,0,3,11,5,16,5,6,3,9,2078,2088,782,2870
curE075a,87,xHard,0.0,left,12440,4432,16872,7,0,7,29,7,36,6,17,10,27,2906,6462,3378,9840
curE078a,7,Easy,1.0,left,4598,1082,5680,2,1,3,9,3,12,1,4,2,6,1942,1670,588,2258
curE078a,8,Easy,1.0,left,2482,1182,3664,2,0,2,7,3,10,2,3,2,5,1122,864,742,1606
curE078a,9,Medium,0.0,left,3898,1532,5430,2,0,2,8,3,11,2,3,2,5,2558,1280,716,1996
curE078a,15,Easy,0.0,right,2332,1916,4248,0,0,0,1,1,2,1,0,0,0,282,0,0,0
curE078a,16,Easy,0.0,right,2332,1982,4314,2,0,2,4,4,8,3,1,2,3,1788,432,1036,1468
curE078a,17,Easy,0.0,left,2332,1848,4180,2,0,2,5,5,10,4,1,3,4,2048,222,1102,1324
curE078a,18,Easy,0.0,left,10276,982,11258,2,1,3,21,3,24,1,19,1,20,940,8824,208,9032
curE078a,19,Easy,0.0,left,2428,1100,3528,1,1,2,6,3,9,1,1,3,4,1004,226,1264,1490
curE078a,22,Easy,0.0,left,2332,4582,6914,2,1,3,6,8,14,6,2,3,5,4548,756,674,1430
curE078a,25,Easy,1.0,right,2328,1234,3562,2,1,3,6,3,9,2,2,3,5,1362,518,844,1362
curE078a,26,Easy,1.0,left,19010,2232,21242,4,0,4,12,2,14,1,7,4,11,884,2842,1688,4530
curE078a,27,Medium,0.0,left,2328,1116,3444,2,0,2,5,3,8,2,1,2,3,1288,196,1076,1272
curE078a,35,Easy,1.0,left,4630,934,5564,3,0,3,11,2,13,1,8,2,10,902,3218,548,3766
curE078a,36,Easy,0.0,left,2332,1216,3548,2,1,3,4,3,7,2,1,2,3,1426,274,1020,1294
curE078a,43,Easy,0.0,left,2332,1384,3716,2,0,2,3,3,6,2,1,1,2,694,312,856,1168
curE078a,46,Easy,1.0,left,2328,2634,4962,2,0,2,4,3,7,2,1,2,3,1584,162,854,1016
curE078a,47,Medium,1.0,left,3528,1350,4878,2,0,2,4,3,7,2,1,2,3,1340,336,896,1232
curE078a,48,Medium,0.0,left,2332,750,3082,2,1,3,5,3,8,1,1,3,4,830,160,1248,1408
curE078a,49,Medium,1.0,left,2332,1050,3382,2,1,3,6,3,9,2,1,4,5,1314,212,1014,1226
curE078a,50,Medium,1.0,left,2332,1118,3450,2,1,3,6,3,9,1,2,3,5,1018,504,1186,1690
curE078a,51,Hard,1.0,left,2332,2616,4948,2,0,2,7,5,12,4,3,2,5,2660,552,858,1410
curE078a,56,Hard,1.0,left,4348,2284,6632,1,1,2,12,5,17,3,10,0,10,1540,2640,0,2640
curE078a,57,Hard,0.0,left,2328,916,3244,2,1,3,4,3,7,1,1,2,3,1714,238,584,822
curE078a,58,Hard,0.0,left,2328,1700,4028,1,0,1,6,4,10,3,2,0,2,2512,690,0,690
curE080a,7,Easy,0.0,right,2432,916,3348,2,1,3,6,3,9,1,1,4,5,332,334,974,1308
curE080a,8,Easy,0.0,right,2328,884,3212,1,1,2,4,3,7,1,1,2,3,1376,498,622,1120
curE080a,9,Easy,0.0,right,2728,916,3644,2,1,3,5,3,8,1,2,2,4,862,1078,712,1790
curE080a,10,Easy,0.0,left,3612,2586,6198,2,1,3,6,6,12,4,2,3,5,2302,574,1998,2572
curE080a,11,Easy,0.0,right,2332,934,3266,1,1,2,5,3,8,1,1,3,4,1158,264,1036,1300
curE080a,12,Easy,0.0,right,2748,10398,13146,1,0,1,6,16,22,13,2,0,2,9226,882,0,882
curE080a,13,Easy,1.0,right,2332,966,3298,1,1,2,3,3,6,1,0,2,2,1904,0,552,552
curE080a,14,Easy,1.0,right,2332,1084,3416,1,0,1,3,3,6,2,0,2,2,540,0,604,604
curE080a,16,Medium,0.0,right,2330,1066,3396,0,0,0,5,3,8,2,0,0,0,2240,0,0,0
curE080a,17,Medium,0.0,right,2332,1000,3332,2,0,2,4,3,7,2,1,2,3,1552,368,712,1080
curE080a,18,Easy,1.0,right,2332,3516,5848,1,1,2,6,8,14,6,2,2,4,3546,530,554,1084
curE080a,19,Easy,1.0,right,2328,884,3212,1,1,2,5,3,8,1,2,1,3,1702,328,248,576
curE080a,22,Medium,1.0,right,2648,1066,3714,2,0,2,7,3,10,2,4,2,6,986,1120,742,1862
curE080a,23,Medium,0.0,right,2444,1016,3460,2,0,2,5,3,8,2,2,2,4,1012,716,990,1706
curE080a,24,Medium,1.0,right,2662,882,3544,2,1,3,7,3,10,1,3,3,6,846,898,704,1602
curE080a,25,Medium,0.0,right,3680,918,4598,3,1,4,8,3,11,1,1,5,6,854,238,2006,2244
curE080a,27,Medium,0.0,right,2332,1466,3798,2,0,2,5,3,8,1,1,2,3,1378,318,538,856
curE080a,28,Easy,1.0,right,2332,1816,4148,0,1,1,5,5,10,3,0,0,0,2950,0,0,0
curE080a,29,Easy,1.0,right,2332,884,3216,2,1,3,4,3,7,1,1,2,3,1272,352,596,948
curE080a,30,Medium,0.0,right,2328,1016,3344,0,0,0,5,3,8,2,0,0,0,2024,0,0,0
curE080a,33,Medium,0.0,left,2332,1734,4066,1,0,1,4,5,9,4,1,0,1,2684,404,10,414
curE080a,34,Easy,0.0,left,2328,1034,3362,1,1,2,3,3,6,1,1,0,1,442,454,0,454
curE080a,35,Easy,0.0,right,4864,1334,6198,2,0,2,9,4,13,3,3,3,6,1582,734,2154,2888
curE080a,36,Easy,0.0,left,2332,1066,3398,1,0,1,3,3,6,2,0,1,1,2100,0,438,438
curE080a,37,Easy,1.0,left,5616,2298,7914,4,0,4,15,4,19,3,8,6,14,2306,3082,1404,4486
curE080a,38,Easy,0.0,left,2332,1732,4064,1,0,1,5,3,8,2,0,2,2,1732,0,1392,1392
curE080a,39,Easy,0.0,left,6276,1000,7276,4,1,5,11,3,14,1,5,4,9,924,3224,994,4218
curE080a,41,Easy,1.0,left,2332,1316,3648,1,0,1,4,4,8,2,1,0,1,2076,318,0,318
curE080a,42,Easy,1.0,left,4364,1084,5448,3,0,3,10,3,13,2,3,5,8,1012,724,2240,2964
curE080a,43,Medium,1.0,left,2610,2366,4976,2,1,3,6,5,11,3,3,1,4,1330,1006,208,1214
curE080a,44,Medium,0.0,left,2682,934,3616,0,1,1,6,3,9,1,0,0,0,1944,0,0,0
curE080a,45,Medium,1.0,left,2328,918,3246,2,1,3,5,3,8,1,2,1,3,972,1044,264,1308
curE080a,46,Medium,0.0,left,2782,1100,3882,1,0,1,7,3,10,2,0,4,4,1770,0,1416,1416
curE080a,48,Medium,1.0,left,2332,1034,3366,2,0,2,6,3,9,2,1,2,3,1546,246,578,824
curE080a,49,Medium,0.0,left,3766,948,4714,1,1,2,5,3,8,1,3,0,3,824,2450,0,2450
curE080a,50,Medium,0.0,left,2328,800,3128,1,1,2,2,3,5,1,1,0,1,1484,458,0,458
curE080a,53,Easy,0.0,left,4114,950,5064,2,1,3,9,3,12,1,5,2,7,1758,1378,734,2112
curE080a,54,Easy,0.0,right,3232,882,4114,2,1,3,7,3,10,1,3,2,5,822,1120,764,1884
curE080a,55,Easy,0.0,right,2382,982,3364,2,1,3,6,2,8,1,1,3,4,936,172,1412,1584
curE080a,56,Easy,0.0,left,4748,1666,6414,4,0,4,10,2,12,1,3,6,9,510,664,2736,3400
curE082a,7,Easy,1.0,left,3514,4532,8046,2,0,2,10,10,20,7,7,2,9,4010,2346,396,2742
curE082a,8,Easy,0.0,left,7962,2184,10146,4,0,4,21,5,26,4,11,8,19,2186,3678,2948,6626
curE082a,10,Easy,1.0,left,2648,1866,4514,3,0,3,6,5,11,3,1,3,4,2048,352,976,1328
curE082a,13,Easy,0.0,left,2332,1050,3382,2,1,3,5,3,8,1,2,2,4,1206,382,1110,1492
curE082a,14,Easy,1.0,left,4816,2854,7670,3,1,4,10,6,16,3,6,3,9,1342,2738,1032,3770
curE082a,22,Easy,0.0,right,2750,1600,4350,2,0,2,7,4,11,3,4,2,6,1600,1434,558,1992
curE082a,23,Easy,0.0,left,2332,1066,3398,2,1,3,6,3,9,1,2,3,5,1186,398,1066,1464
curE082a,24,Easy,0.0,left,2666,1732,4398,2,1,3,8,5,13,3,6,1,7,1562,1616,390,2006
curE082a,25,Easy,0.0,left,2332,1550,3882,2,1,3,4,3,7,1,1,2,3,1806,170,996,1166
curE082a,26,Easy,1.0,left,2332,1184,3516,1,1,2,5,3,8,1,1,3,4,1396,158,1276,1434
curE082a,31,Easy,1.0,left,7194,1300,8494,3,0,3,8,3,11,2,3,4,7,1300,916,2618,3534
curE082a,32,Medium,0.0,left,2332,1284,3616,2,1,3,4,3,7,1,1,2,3,1800,290,816,1106
curE082a,33,Medium,1.0,left,5712,6132,11844,2,0,2,9,6,15,5,2,5,7,3464,1828,2670,4498
curE082a,40,Medium,0.0,right,12678,1068,13746,2,1,3,11,3,14,1,9,1,10,1028,4524,544,5068
curE090a,7,Easy,1.0,right,6614,1132,7746,3,0,3,16,3,19,2,5,7,12,1538,1162,3764,4926
curE090a,8,Easy,1.0,left,17606,1098,18704,4,0,4,29,3,32,2,15,12,27,1068,5414,3098,8512
curE090a,9,Medium,0.0,left,2832,584,3416,2,1,3,8,1,9,0,2,5,7,0,558,1264,1822
curE090a,10,Medium,0.0,left,5260,1166,6426,2,0,2,15,3,18,2,4,9,13,966,1020,3386,4406
curE090a,11,Easy,0.0,left,7998,2582,10580,3,2,5,17,4,21,2,7,9,16,1612,2764,3930,6694
curE090a,13,Easy,1.0,left,5598,1166,6764,3,1,4,16,4,20,2,3,11,14,1152,1048,3160,4208
curE090a,14,Easy,1.0,left,4544,2374,6918,2,1,3,12,7,19,5,2,9,11,1968,604,3008,3612
curE090a,15,Medium,1.0,left,2564,2568,5132,2,0,2,7,7,14,6,2,3,5,2500,400,1342,1742
curE090a,16,Medium,1.0,right,2466,3998,6464,2,2,4,7,6,13,3,1,5,6,1550,348,1238,1586
curE090a,17,Hard,1.0,right,8280,1634,9914,3,1,4,17,5,22,3,10,6,16,1588,3750,2976,6726
curE090a,18,Hard,0.0,left,6560,1300,7860,3,1,4,12,5,17,3,6,5,11,1234,2896,2194,5090
curE090a,19,Hard,0.0,right,11808,2416,14224,4,1,5,30,6,36,4,14,15,29,1866,5156,4786,9942
curE090a,20,Medium,0.0,left,3492,1368,4860,2,0,2,10,4,14,3,4,4,8,1310,1696,954,2650
curE090a,22,Medium,1.0,left,2794,1032,3826,2,1,3,9,3,12,2,3,4,7,938,602,1046,1648
curE090a,23,Medium,1.0,left,2732,566,3298,2,1,3,7,2,9,0,1,4,5,440,376,1428,1804
curE090a,24,Hard,0.0,left,8148,2698,10846,5,0,5,16,7,23,5,8,6,14,2088,2032,1348,3380
curE090a,26,Hard,1.0,right,12512,1566,14078,4,0,4,26,2,28,1,14,11,25,198,4648,3462,8110
curE090a,28,Hard,0.0,right,4130,1434,5564,3,1,4,11,3,14,2,4,4,8,2084,996,1352,2348
curE090a,29,Hard,0.0,left,3832,3044,6876,2,1,3,6,5,11,3,3,2,5,2576,1758,1232,2990
curE090a,30,Medium,1.0,right,4360,3782,8142,2,1,3,10,8,18,5,3,6,9,1792,1444,1864,3308
curE090a,31,Medium,0.0,right,5910,1650,7560,2,0,2,13,3,16,2,6,4,10,1722,3358,1462,4820
curE090a,32,Medium,1.0,left,4730,2582,7312,2,0,2,10,6,16,3,3,5,8,1782,834,1142,1976
curE090a,34,Hard,0.0,left,10362,2066,12428,3,2,5,13,4,17,1,7,5,12,734,2286,1128,3414
curE090a,35,Hard,1.0,right,4712,1584,6296,3,0,3,14,5,19,4,3,9,12,1514,772,2680,3452
curE090a,37,Hard,0.0,left,3992,2150,6142,2,1,3,10,7,17,5,5,3,8,2022,1938,764,2702
curE090a,38,Hard,0.0,right,3814,1682,5496,2,1,3,12,2,14,0,6,4,10,476,2034,968,3002
curE090a,42,Medium,1.0,right,7364,1366,8730,5,0,5,18,4,22,3,6,10,16,1176,1416,4438,5854
curE090a,43,Medium,1.0,right,14130,1082,15212,4,0,4,24,3,27,2,7,13,20,780,2114,6098,8212
curE090a,44,Hard,0.0,right,6064,584,6648,3,1,4,14,2,16,0,4,8,12,478,1302,3724,5026
curE090a,51,Hard,0.0,right,4848,4366,9214,2,2,4,8,10,18,8,4,2,6,3822,1950,410,2360
curE090a,53,Hard,0.0,left,4796,3416,8212,3,1,4,11,5,16,3,3,6,9,1350,1734,2116,3850
curE092a,7,Easy,1.0,left,2716,6734,9450,2,2,4,6,12,18,5,1,4,5,2112,432,1250,1682
curE092a,8,Easy,1.0,left,6278,1932,8210,2,0,2,8,4,12,3,4,3,7,1932,1486,730,2216
curE092a,9,Medium,0.0,left,3716,1416,5132,2,1,3,8,4,12,2,2,4,6,824,854,1594,2448
curE092a,10,Medium,0.0,left,6164,4416,10580,4,0,4,14,5,19,3,6,6,12,1612,2206,1886,4092
curE092a,12,Easy,0.0,right,4514,5464,9978,3,1,4,11,11,22,8,5,4,9,4530,1536,1552,3088
curE092a,13,Easy,1.0,right,3248,1184,4432,3,0,3,8,3,11,2,3,3,6,1116,830,994,1824
curE092a,15,Easy,1.0,left,3978,2348,6326,2,0,2,9,7,16,6,4,4,8,2292,1084,1466,2550
curE092a,16,Easy,1.0,left,2712,1466,4178,2,0,2,7,3,10,2,2,4,6,1456,590,1376,1966
curE092a,17,Medium,0.0,right,3930,2450,6380,2,0,2,8,4,12,3,4,2,6,2704,1188,708,1896
curE092a,18,Medium,1.0,right,4298,3098,7396,3,1,4,11,10,21,8,4,5,9,2930,1174,1586,2760
curE092a,20,Medium,1.0,right,8814,2350,11164,1,1,2,8,4,12,3,3,5,8,1760,920,2062,2982
curE092a,22,Medium,0.0,left,2448,1366,3814,2,0,2,5,3,8,2,3,1,4,1350,1154,392,1546
curE092a,24,Medium,0.0,left,8298,4498,12796,4,0,4,11,4,15,3,5,5,10,1196,1094,1988,3082
curE092a,25,Medium,1.0,left,6880,8032,14912,1,0,1,6,2,8,1,3,3,6,248,1282,1352,2634
curE092a,29,Medium,1.0,right,12558,8898,21456,6,0,6,28,8,36,7,12,14,26,2462,3458,3176,6634
curE092a,30,Hard,0.0,right,3612,2082,5694,3,1,4,9,6,15,4,3,4,7,1402,1042,1388,2430
curE092a,31,Hard,1.0,right,4316,1950,6266,3,0,3,9,5,14,4,3,5,8,1946,1152,1412,2564
curE092a,32,Hard,0.0,right,8046,3966,12012,5,0,5,13,9,22,8,4,7,11,3774,2406,2888,5294
curE098a,7,Easy,1.0,left,2714,582,3296,1,1,2,5,2,7,0,4,0,4,530,1994,0,1994
curE098a,9,Medium,1.0,right,4368,1680,6048,4,0,4,11,3,14,2,3,6,9,1974,726,1808,2534
curE098a,10,Medium,0.0,left,4130,1384,5514,1,0,1,6,4,10,3,4,0,4,1474,2838,0,2838
curE098a,15,Medium,0.0,left,2410,1650,4060,1,0,1,4,3,7,2,3,0,3,1648,1698,0,1698
curE098a,21,Easy,0.0,right,5132,1948,7080,3,1,4,9,4,13,2,3,4,7,1766,1320,2176,3496
curE098a,22,Easy,0.0,left,5116,2332,7448,2,0,2,11,4,15,3,4,5,9,2072,898,1608,2506
curE098a,23,Easy,0.0,left,4776,4316,9092,1,1,2,6,9,15,7,5,0,5,3252,3854,0,3854
curE098a,24,Easy,1.0,left,12424,566,12990,6,1,7,17,2,19,0,7,8,15,472,2542,3910,6452
curE098a,25,Easy,1.0,left,2330,1784,4114,1,1,2,5,3,8,2,0,4,4,1768,0,1148,1148
curE098a,32,Medium,0.0,left,15844,2398,18242,3,0,3,21,5,26,4,17,2,19,2348,5490,430,5920
curE098a,35,Easy,1.0,left,3198,10038,13236,2,0,2,5,11,16,11,3,1,4,3062,2210,118,2328
curE098a,36,Easy,1.0,left,3766,4648,8414,1,1,2,7,10,17,8,3,2,5,4576,1458,1028,2486
curE098a,37,Medium,0.0,right,18710,8864,27574,9,1,10,20,16,36,15,9,8,17,6820,3294,5244,8538
curE098a,38,Medium,0.0,left,5298,2216,7514,3,1,4,11,5,16,3,4,5,9,1608,1104,2248,3352
curE098a,39,Easy,0.0,left,15224,2434,17658,1,0,1,37,4,41,3,36,0,36,2236,12174,0,12174
curE098a,42,Easy,1.0,left,2332,1266,3598,2,1,3,4,3,7,1,1,2,3,1518,388,856,1244
curE104a,12,Easy,1.0,left,6810,1182,7992,4,0,4,16,3,19,2,9,6,15,1182,2566,2722,5288
curE104a,13,Easy,1.0,left,2378,1398,3776,0,0,0,4,3,7,2,0,0,0,2660,0,0,0
curE104a,14,Medium,0.0,left,4148,1982,6130,1,0,1,9,5,14,4,0,4,4,3288,0,886,886
curE104a,15,Medium,1.0,right,2378,2116,4494,0,0,0,0,5,5,4,0,0,0,1114,0,0,0
curE104a,16,Medium,0.0,left,6182,1216,7398,2,0,2,16,3,19,2,9,6,15,1078,2548,2706,5254
curE104a,17,Medium,1.0,left,2332,950,3282,0,1,1,8,3,11,1,0,0,0,1548,0,0,0
curE104a,20,Hard,1.0,right,2482,1066,3548,1,0,1,5,3,8,2,3,1,4,1058,894,710,1604
curE104a,21,Hard,0.0,left,10926,1000,11926,5,1,6,24,3,27,1,11,12,23,764,4278,3872,8150
curE104a,23,Medium,0.0,right,14544,10038,24582,4,0,4,23,26,49,26,15,7,22,5900,5944,2428,8372
curE104a,25,Medium,1.0,left,4048,1100,5148,2,0,2,11,3,14,2,5,5,10,1112,1716,1418,3134
curE104a,28,Medium,0.0,left,4162,1082,5244,3,0,3,10,3,13,2,3,4,7,552,1126,1370,2496
curE104a,31,Medium,0.0,right,19660,10038,29698,1,0,1,47,2,49,2,46,0,46,1016,10762,0,10762
curE104a,40,Medium,0.0,right,14190,10036,24226,7,0,7,34,20,54,20,25,7,32,8036,9516,2632,12148
curE104a,43,Medium,0.0,left,4030,1034,5064,3,0,3,11,3,14,2,7,3,10,806,2094,522,2616
curE104a,44,Medium,1.0,left,9264,2040,11304,2,1,3,9,3,12,1,0,9,9,420,0,4034,4034
curE106a,9,Easy,0.0,left,4708,3566,8274,2,0,2,7,4,11,3,3,3,6,3552,2748,1072,3820
curE106a,10,Easy,1.0,left,8342,1516,9858,2,0,2,12,4,16,3,8,3,11,1518,3246,690,3936
curE106a,11,Easy,0.0,left,5396,3866,9262,1,1,2,6,7,13,5,4,0,4,3276,3940,0,3940
curE106a,14,Easy,1.0,left,4246,10040,14286,1,0,1,9,13,22,13,3,0,3,9452,742,0,742
curE106a,18,Medium,1.0,left,2682,2550,5232,2,1,3,5,5,10,4,3,1,4,2414,842,198,1040
curE106a,19,Medium,0.0,left,4242,3916,8158,2,1,3,10,8,18,7,4,2,6,5222,1056,672,1728
curE106a,21,Medium,1.0,left,4948,3666,8614,2,0,2,12,7,19,5,4,4,8,4718,1178,1646,2824
curE106a,22,Medium,1.0,right,4260,4032,8292,2,0,2,11,5,16,5,2,5,7,5094,524,1170,1694
curE106a,23,Hard,1.0,left,11090,1950,13040,4,0,4,27,4,31,3,11,15,26,1950,3968,4214,8182
curE106a,24,Hard,0.0,left,2632,3450,6082,2,0,2,7,7,14,7,3,3,6,2942,1154,806,1960
curE106a,25,Hard,1.0,right,10028,5714,15742,1,0,1,11,13,24,11,5,3,8,6060,1444,1158,2602
curE106a,27,Hard,0.0,left,8364,1998,10362,0,1,1,0,3,3,1,0,0,0,696,0,0,0
curE106a,28,Hard,1.0,left,5126,5336,10462,1,1,2,12,10,22,9,10,0,10,4456,2818,0,2818
curE106a,30,Hard,0.0,left,2544,2582,5126,1,1,2,7,6,13,4,2,4,6,2516,496,1086,1582
curE106a,31,Hard,0.0,left,18404,2266,20670,3,0,3,30,4,34,3,23,4,27,2260,14064,1762,15826
curE106a,33,Medium,1.0,left,9258,6364,15622,7,0,7,20,8,28,7,8,9,17,6442,2242,5014,7256
curE106a,35,Medium,0.0,left,9174,2400,11574,4,0,4,17,6,23,4,7,8,15,2168,5094,2464,7558
curE106a,37,Medium,1.0,left,3926,2332,6258,2,0,2,9,6,15,4,3,5,8,2084,1124,1918,3042
curE106a,38,Medium,1.0,right,4792,2782,7574,3,0,3,10,1,11,1,6,2,8,608,2812,906,3718
curE106a,40,Hard,1.0,left,5798,5166,10964,2,0,2,14,9,23,8,7,4,11,5616,1646,822,2468
curE106a,41,Hard,0.0,left,18986,4482,23468,3,1,4,25,6,31,4,12,12,24,4432,3646,5414,9060
curE106a,44,Hard,1.0,left,5844,2800,8644,3,0,3,13,5,18,3,5,6,11,2504,1684,2704,4388
curE106a,45,Hard,1.0,left,6930,3866,10796,2,1,3,16,9,25,8,7,7,14,3082,1620,3344,4964
curE106a,47,xHard,0.0,right,2330,7030,9360,0,0,0,5,11,16,9,0,0,0,5566,0,0,0
curE106a,48,xHard,1.0,left,2328,2466,4794,2,0,2,4,6,10,5,2,1,3,2698,766,564,1330
curE106a,49,xHard,1.0,right,9446,2132,11578,2,0,2,17,4,21,3,11,5,16,1918,4272,2090,6362
curE106a,54,xHard,1.0,left,12056,2182,14238,5,0,5,12,5,17,3,2,9,11,1532,1124,4064,5188
curE106a,56,xHard,0.0,left,6314,9832,16146,1,0,1,14,16,30,15,11,0,11,5572,3502,0,3502
curE106a,58,xHard,1.0,left,8994,2432,11426,3,1,4,21,6,27,3,11,8,19,1976,3690,2750,6440
curE106a,61,xHard,1.0,left,2326,3582,5908,1,0,1,4,4,8,4,2,0,2,3226,744,0,744
curE109a,9,Easy,1.0,right,2332,566,2898,2,1,3,6,2,8,0,2,1,3,910,812,318,1130
curE109a,11,Easy,0.0,right,16644,1966,18610,1,1,2,15,6,21,4,9,0,9,2362,2732,0,2732
curE109a,12,Easy,1.0,right,4282,1982,6264,2,0,2,12,3,15,3,8,0,8,2748,2552,0,2552
curE109a,13,Easy,1.0,left,6914,1466,8380,4,0,4,12,3,15,2,6,4,10,1598,2260,1084,3344
curE109a,14,Medium,1.0,left,7248,1666,8914,4,0,4,14,5,19,4,7,3,10,2554,4036,970,5006
curE109a,15,Medium,0.0,left,2334,2716,5050,2,1,3,6,7,13,4,2,2,4,2078,726,642,1368
curE109a,16,Medium,1.0,right,3764,9980,13744,2,0,2,10,12,22,10,5,3,8,4554,1744,864,2608
curE109a,17,Medium,0.0,left,7052,1428,8480,4,1,5,19,3,22,1,6,10,16,1472,2256,3058,5314
curE109a,18,Medium,1.0,left,8208,1266,9474,3,1,4,15,2,17,1,7,6,13,690,2518,1836,4354
curE109a,19,Medium,0.0,left,2378,1918,4296,2,0,2,7,4,11,3,4,2,6,1740,902,710,1612
curE109a,20,Medium,1.0,right,3110,568,3678,2,1,3,8,1,9,0,5,2,7,474,1656,486,2142
curE109a,22,Medium,1.0,left,7080,1450,8530,2,1,3,9,4,13,2,5,3,8,1006,2220,1086,3306
curE109a,24,Medium,1.0,left,16794,2116,18910,2,1,3,9,1,10,0,4,2,6,754,1090,612,1702
curE109a,29,Easy,0.0,left,6882,2116,8998,1,0,1,8,4,12,3,3,2,5,2042,846,810,1656
curE109a,33,Easy,1.0,left,4648,2234,6882,2,0,2,7,6,13,5,1,4,5,2742,394,2516,2910
curE109a,34,Medium,1.0,right,2798,10038,12836,2,0,2,7,9,16,8,3,2,5,4622,1074,746,1820
curE109a,36,Medium,1.0,right,3628,1900,5528,2,0,2,8,5,13,3,2,4,6,1744,650,1790,2440
curE109a,38,Hard,0.0,left,14142,1986,16128,3,1,4,10,2,12,0,1,9,10,36,484,3952,4436
curE112a,9,Medium,1.0,left,4080,1916,5996,1,0,1,8,4,12,3,2,5,7,1760,606,2336,2942
curE112a,10,Medium,0.0,left,7480,2316,9796,3,2,5,15,5,20,2,4,10,14,1696,2698,3180,5878
curE112a,12,Medium,1.0,right,3830,2622,6452,1,0,1,2,2,4,2,2,0,2,1074,542,0,542
curE112a,13,Hard,1.0,left,2532,2466,4998,0,0,0,0,3,3,2,0,0,0,408,0,0,0
curE112a,14,Hard,0.0,right,7810,1420,9230,2,0,2,13,3,16,2,2,4,6,1824,840,1494,2334
curE112a,15,Hard,0.0,right,2328,566,2894,1,1,2,5,2,7,0,0,3,3,634,0,1236,1236
curE112a,16,Medium,1.0,right,13844,1750,15594,3,1,4,18,4,22,2,8,7,15,1404,3080,3132,6212
curE112a,17,Medium,0.0,right,3030,1832,4862,2,0,2,8,3,11,2,3,3,6,1532,1194,1076,2270
curE112a,19,Medium,0.0,right,10592,2964,13556,3,1,4,26,6,32,5,5,20,25,2390,1318,5826,7144
curE112a,20,Easy,1.0,right,3182,3066,6248,1,0,1,8,5,13,4,1,5,6,2958,608,1650,2258
curE112a,22,Easy,1.0,right,3598,5664,9262,3,1,4,9,11,20,9,1,5,6,5250,222,1910,2132
curE112a,36,Easy,0.0,left,3260,1066,4326,2,1,3,6,3,9,1,2,3,5,1016,562,1734,2296
curE112a,37,Easy,1.0,right,12962,6664,19626,2,2,4,23,14,37,11,14,8,22,6020,6160,3868,10028
curE112a,39,Easy,0.0,left,16142,4198,20340,3,0,3,19,7,26,4,7,11,18,2914,2800,6166,8966
curE112a,41,Easy,0.0,left,5198,2234,7432,3,0,3,14,5,19,4,5,7,12,1698,1764,1972,3736
curE112a,43,Easy,1.0,right,3276,4100,7376,1,1,2,7,9,16,6,0,4,4,3638,0,1884,1884
curE113a,7,Easy,1.0,left,4530,948,5478,2,0,2,10,3,13,2,1,3,4,1700,206,504,710
curE113a,9,Easy,1.0,right,4016,3414,7430,2,0,2,9,6,15,5,1,5,6,4460,182,1816,1998
curE113a,10,Easy,1.0,left,2326,966,3292,1,1,2,3,3,6,1,0,1,1,2210,0,306,306
curE113a,12,Medium,0.0,right,17056,2150,19206,1,0,1,6,5,11,4,0,3,3,2490,0,1170,1170
curE113a,13,Easy,1.0,left,7694,934,8628,2,0,2,12,2,14,1,0,9,9,1534,0,4516,4516
curE113a,15,Easy,0.0,left,4064,2650,6714,1,1,2,7,1,8,0,4,0,4,562,1524,0,1524
curE113a,24,Easy,0.0,left,9758,5944,15702,1,1,2,7,13,20,11,5,0,5,4910,1590,0,1590
curE113a,28,Easy,1.0,left,4182,10038,14220,0,0,0,2,10,12,10,0,0,0,2444,0,0,0
curE113a,31,Easy,1.0,right,2332,600,2932,1,1,2,3,1,4,0,1,0,1,1610,534,0,534
curE113a,32,Easy,0.0,left,3298,982,4280,1,1,2,7,2,9,1,3,2,5,1422,768,670,1438
curE113a,34,Easy,1.0,left,2796,1216,4012,1,1,2,6,4,10,2,4,0,4,916,2020,0,2020
curE113a,35,Medium,1.0,right,2332,3782,6114,1,0,1,3,6,9,6,0,2,2,2912,0,914,914
curE115a,10,Easy,1.0,right,2332,10036,12368,1,0,1,5,18,23,15,0,3,3,6186,0,1248,1248
curE115a,11,Easy,1.0,left,7112,2100,9212,6,0,6,14,3,17,3,5,7,12,1654,1846,3640,5486
curE115a,12,Medium,1.0,right,5848,1948,7796,1,0,1,12,6,18,4,0,10,10,1708,0,2412,2412
curE115a,13,Medium,1.0,right,7298,2416,9714,5,0,5,15,5,20,4,5,8,13,2282,2434,2604,5038
curE115a,14,Hard,0.0,left,2332,7248,9580,1,0,1,5,12,17,8,0,3,3,5064,0,1074,1074
curE115a,15,Hard,0.0,right,6412,6598,13010,3,0,3,14,13,27,13,8,4,12,3768,2490,1480,3970
curE115a,21,Easy,0.0,right,3132,5348,8480,1,0,1,8,9,17,8,3,3,6,4904,832,1162,1994
curE115a,22,Easy,1.0,left,7580,1784,9364,3,0,3,16,3,19,2,12,2,14,1544,5470,930,6400
curE115a,23,Easy,0.0,left,8830,1750,10580,5,1,6,20,5,25,3,8,7,15,856,3318,2298,5616
curE115a,24,Easy,0.0,right,2332,7498,9830,1,0,1,5,11,16,10,0,2,2,4312,0,962,962
curE115a,25,Easy,1.0,left,16128,2300,18428,5,0,5,24,3,27,2,13,10,23,1028,3754,3006,6760
curE115a,26,Easy,1.0,left,17162,8912,26074,2,1,3,23,6,29,4,19,3,22,2712,5528,480,6008
curE115a,27,Medium,1.0,right,2714,3100,5814,1,1,2,8,7,15,5,6,0,6,2792,1636,0,1636
curE115a,28,Medium,1.0,right,2332,4198,6530,2,0,2,7,1,8,1,3,1,4,474,752,166,918
curE119a,9,Easy,1.0,right,2326,850,3176,1,1,2,8,1,9,0,4,2,6,536,758,614,1372
curE119a,11,Medium,1.0,right,3214,950,4164,1,1,2,3,3,6,1,0,3,3,210,0,776,776
curE119a,12,Hard,0.0,right,2346,1300,3646,2,1,3,7,3,10,2,4,2,6,1270,1044,466,1510
curE119a,13,Hard,1.0,right,2332,1832,4164,1,1,2,6,4,10,2,2,3,5,1558,536,804,1340
curE119a,14,Hard,0.0,right,2332,1982,4314,1,0,1,5,4,9,3,0,3,3,2196,0,972,972
curE119a,23,xHard,1.0,right,3430,4548,7978,1,1,2,7,8,15,5,0,4,4,2880,0,1162,1162
curE119a,24,xHard,1.0,right,3162,4916,8078,1,0,1,4,6,10,5,1,1,2,3628,212,1352,1564
curE119a,26,xHard,1.0,right,2498,10038,12536,2,2,4,5,13,18,9,1,2,3,4864,668,604,1272
curE119a,27,xHard,0.0,right,2880,7132,10012,2,0,2,7,10,17,8,1,3,4,3806,642,666,1308
curE119a,34,Hard,1.0,right,9998,1980,11978,3,0,3,12,4,16,3,4,4,8,2046,1384,1304,2688
curE119a,36,Hard,0.0,right,11196,8248,19444,3,1,4,19,10,29,8,5,11,16,6394,1710,4294,6004
curE119a,37,Hard,1.0,right,2332,5516,7848,1,1,2,4,11,15,9,0,1,1,5646,0,328,328
curE119a,38,Hard,1.0,left,2332,3116,5448,1,0,1,4,3,7,2,2,0,2,2314,1102,0,1102
curE120a,7,Easy,0.0,left,3318,10044,13362,3,0,3,7,7,14,7,0,3,3,3868,0,1242,1242
curE120a,13,Easy,0.0,left,4080,10040,14120,1,1,2,6,14,20,12,0,3,3,6716,0,1564,1564
curE120a,17,Easy,0.0,right,2500,1182,3682,1,0,1,3,1,4,1,2,0,2,890,352,0,352
curE120a,20,Easy,1.0,left,5330,1066,6396,1,1,2,9,2,11,1,0,7,7,1218,0,3350,3350
curE120a,23,Easy,1.0,right,3080,600,3680,1,1,2,3,2,5,0,1,0,1,280,866,0,866
curE120a,24,Easy,1.0,right,7424,10044,17468,1,0,1,5,12,17,12,5,0,5,4360,2678,0,2678
curE120a,27,Medium,0.0,left,3962,1784,5746,0,0,0,0,4,4,3,0,0,0,1234,0,0,0
curE120a,28,Medium,0.0,right,2694,1066,3760,1,0,1,2,1,3,1,0,1,1,664,0,230,230
curE120a,29,Easy,0.0,left,3332,10038,13370,1,0,1,4,12,16,12,0,2,2,3976,0,1026,1026
curE120a,31,Easy,1.0,right,5746,10040,15786,1,1,2,5,11,16,9,0,3,3,5972,0,2288,2288
curE120a,33,Easy,0.0,right,2980,3182,6162,1,0,1,2,6,8,4,0,1,1,1808,0,336,336
curE120a,34,Easy,0.0,left,2916,2400,5316,1,1,2,3,5,8,3,0,2,2,2032,0,2330,2330
curE120a,35,Easy,1.0,right,4480,10038,14518,2,1,3,10,9,19,8,3,4,7,4610,990,1374,2364
curE120a,39,Easy,1.0,right,8058,568,8626,2,1,3,7,2,9,0,6,0,6,340,2082,0,2082
curE120a,40,Easy,1.0,right,4714,2316,7030,1,2,3,7,6,13,4,0,6,6,1880,0,1982,1982
curE120a,41,Medium,0.0,right,2998,9008,12006,2,0,2,5,9,14,8,2,3,5,2940,826,784,1610
curE121a,7,Easy,0.0,left,2416,1282,3698,2,1,3,7,3,10,2,4,2,6,1202,1010,582,1592
curE121a,8,Easy,0.0,left,4530,1266,5796,2,1,3,6,3,9,2,3,2,5,890,1018,1444,2462
curE121a,11,Easy,1.0,left,2716,1400,4116,2,1,3,5,4,9,3,2,1,3,1654,696,342,1038
curE121a,12,Easy,1.0,left,3182,950,4132,2,1,3,8,2,10,1,1,4,5,1604,254,1302,1556
curE121a,13,Medium,0.0,left,17394,550,17944,4,0,4,22,0,22,0,11,10,21,444,3932,3236,7168
curE121a,14,Medium,1.0,left,6014,1084,7098,2,0,2,9,2,11,1,1,7,8,770,398,2784,3182
curE121a,15,Medium,0.0,left,8298,932,9230,2,0,2,11,2,13,1,8,2,10,826,3518,550,4068
curE121a,17,Medium,0.0,right,10296,566,10862,2,1,3,21,1,22,0,6,14,20,444,1428,4230,5658
curE121a,18,Easy,1.0,left,2916,1200,4116,2,1,3,3,3,6,2,2,1,3,492,956,310,1266
curE121a,21,Easy,1.0,left,5832,932,6764,1,1,2,3,2,5,1,2,0,2,408,1476,0,1476
curE121a,22,Easy,1.0,right,12092,2000,14092,2,0,2,15,5,20,5,10,3,13,1488,3440,854,4294
curE121a,23,Medium,1.0,left,11262,1266,12528,2,1,3,11,4,15,2,4,5,9,1006,1188,2158,3346
curE121a,33,Easy,0.0,right,3966,582,4548,2,1,3,5,1,6,0,2,2,4,532,504,2664,3168
curE122a,7,Easy,0.0,right,8096,1384,9480,4,0,4,21,6,27,4,15,3,18,1200,5538,912,6450
curE122a,8,Easy,1.0,left,13762,4716,18478,6,1,7,29,13,42,11,8,18,26,4442,2664,8588,11252
curE122a,9,Easy,1.0,right,11728,1500,13228,5,1,6,20,4,24,2,9,10,19,1232,4246,3950,8196
curE122a,11,Medium,0.0,left,8380,966,9346,2,1,3,10,1,11,0,6,3,9,540,2336,854,3190
curE122a,15,Easy,1.0,left,4730,1234,5964,2,0,2,9,3,12,2,3,4,7,1628,1056,2092,3148
curE122a,16,Easy,0.0,left,6080,1298,7378,1,0,1,13,4,17,2,7,3,10,1974,3370,790,4160
curE122a,19,Easy,0.0,left,2716,1200,3916,3,1,4,9,4,13,2,4,2,6,918,730,496,1226
curE122a,25,Easy,1.0,left,2714,8398,11112,1,0,1,7,9,16,8,3,0,3,4450,718,2,720
curE122a,26,Medium,0.0,left,2378,566,2944,1,1,2,5,1,6,0,3,0,3,570,1160,0,1160
curE122a,27,Medium,1.0,left,13092,1598,14690,2,0,2,20,5,25,4,15,3,18,1484,8504,894,9398
curE122a,28,Medium,1.0,right,13796,566,14362,3,1,4,22,2,24,0,5,16,21,288,1178,5768,6946
curE122a,35,Hard,1.0,left,16894,1432,18326,5,0,5,38,0,38,0,22,15,37,118,6830,4860,11690
curE122a,38,Hard,1.0,left,2414,582,2996,2,1,3,5,2,7,0,2,1,3,502,1316,270,1586
curE122a,48,Medium,0.0,left,2332,968,3300,1,1,2,2,3,5,1,1,0,1,2104,596,0,596
